State,Year,Coal,Natural gas,Petroleum,Nuclear,Total renewable energy,TotalEnergy,PercentRenewable,PercentNonRenewable
AK,1960,7189,2034,45410,0,4670,59303,7.874812404094228,92.12518759590577
AL,1960,395400,190706,236010,0,66967,889083,7.5321426683448,92.4678573316552
AR,1960,356,222202,148055,0,40817,411430,9.920764164013319,90.07923583598668
AZ,1960,210,140275,121344,0,14214,276043,5.149197769912658,94.85080223008734
CA,1960,35903,1301826,1836912,1,141733,3316375,4.27373261467717,95.72626738532283
CO,1960,68206,194963,161701,0,9788,434658,2.251885390352875,97.74811460964712
CT,1960,101694,29449,362231,0,14289,507663,2.814662482788779,97.18533751721122
DC,1960,27792,12951,59884,0,133,100760,0.13199682413656214,99.86800317586344
DE,1960,20496,9351,123940,0,4982,158769,3.137892157788989,96.86210784221102
FL,1960,27176,142900,611909,0,33638,815623,4.124209346720237,95.87579065327976
GA,1960,88950,188460,301423,0,79073,657906,12.01889023659915,87.98110976340085
HI,1960,0,0,94547,0,93,94640,0.09826711749788673,99.90173288250212
IA,1960,115945,193688,284968,0,9410,604011,1.5579186471769555,98.44208135282304
ID,1960,16845,22776,73643,0,32388,145652,22.23656386455387,77.76343613544613
IL,1960,914648,536127,1101969,2958,31663,2587365,1.2237546693257426,98.77624533067426
IN,1960,794942,219758,600655,0,23819,1639174,1.453109919996291,98.5468900800037
KS,1960,15724,373664,252417,0,3979,645784,0.6161502917384141,99.38384970826158
KY,1960,286738,153807,200419,0,31402,672366,4.6703729813821635,95.32962701861784
LA,1960,0,1003771,466937,0,38992,1509700,2.5827647877061666,97.41723521229383
MA,1960,118745,80612,804058,394,46135,1049944,4.394043872816074,95.60595612718393
MD,1960,226566,73315,353177,0,28471,681529,4.177518491509532,95.82248150849047
ME,1960,20408,0,152342,0,38883,211633,18.372843554644124,81.62715644535588
MI,1960,653141,382980,713352,0,44186,1793659,2.463455985781021,97.53654401421898
MN,1960,131265,186121,381283,0,28441,727110,3.911512700966841,96.08848729903316
MO,1960,170906,270074,403574,0,36110,880664,4.100315216700126,95.89968478329988
MS,1960,753,187874,142266,0,46565,377458,12.336471872367257,87.66352812763274
MT,1960,3999,57638,106971,0,27312,195920,13.94038383013475,86.05961616986525
NC,1960,231342,47032,418929,0,90780,788083,11.519091263229889,88.48090873677012
ND,1960,30531,27356,101649,0,4090,163626,2.499602752618777,97.50039724738123
NE,1960,20010,140430,136000,0,6379,302819,2.1065388895676955,97.8934611104323
NH,1960,5390,2952,83382,0,15540,107264,14.487619331742243,85.51238066825776
NJ,1960,168775,144132,955611,0,20187,1288705,1.566456248714795,98.4335437512852
NM,1960,4064,207301,106623,0,6864,324852,2.1129622104835435,97.88703778951646
NV,1960,3962,12883,54380,0,7657,78882,9.706903983164727,90.29309601683528
NY,1960,691728,434127,1700047,0,100502,2926404,3.4343173396427833,96.56568266035721
OH,1960,1269205,724824,796707,0,36822,2827558,1.3022544541968724,98.69774554580313
OK,1960,1826,319270,254680,0,12589,588365,2.1396582053657167,97.86034179463428
OR,1960,8943,31941,212447,0,98889,352220,28.075918460053376,71.92408153994663
PA,1960,1530508,540094,1120870,2674,52683,3246829,1.622598541530829,98.37740145846917
RI,1960,16754,12253,153624,0,2888,185519,1.5567138675822962,98.4432861324177
SC,1960,96414,60581,219200,0,55439,431634,12.843983560145864,87.15601643985414
SD,1960,6707,25392,86178,0,5481,123758,4.428804602530746,95.57119539746925
TN,1960,374478,151740,228239,0,74957,829414,9.037344438362506,90.96265556163749
TX,1960,24974,2815483,1536057,0,42057,4418571,0.9518235646773584,99.04817643532265
UT,1960,90967,72441,127551,0,3258,294217,1.1073459385419606,98.89265406145805
VA,1960,316395,68431,442254,0,60396,887476,6.805367131054812,93.19463286894519
VT,1960,3507,0,46623,0,10922,61052,17.889667824149907,82.11033217585009
WA,1960,15231,67207,356807,0,175732,614977,28.57537761574823,71.42462238425176
WI,1960,304624,93792,392174,0,47340,837930,5.649636604489635,94.35036339551037
WV,1960,354418,155554,126727,0,16569,653268,2.5363250610775365,97.46367493892247
WY,1960,15763,52828,75496,0,3700,147787,2.503603158599877,97.49639684140013
US,1960,9830513,12385366,19873652,6026,1829874,43925431,4.165864644560915,95.83413535543909
AK,1961,11552,2300,51008,0,5160,70020,7.369323050556984,92.63067694944301
AL,1961,382455,191533,232362,0,69190,875540,7.9025515681750695,92.09744843182493
AR,1961,275,215311,159835,0,41049,416470,9.856412226570942,90.14358777342906
AZ,1961,211,159093,126775,0,13847,299926,4.616805478684742,95.38319452131526
CA,1961,59106,1400174,1892977,55,136263,3488575,3.9059788022330033,96.09402119776699
CO,1961,76938,210872,174643,0,9415,471868,1.995261386658981,98.00473861334102
CT,1961,107540,31424,365569,0,14421,518954,2.7788590125521724,97.22114098744782
DC,1961,25770,13721,56135,0,124,95750,0.12950391644908615,99.87049608355092
DE,1961,20776,9708,117413,0,5101,152998,3.334030510202748,96.66596948979725
FL,1961,36267,148894,634303,0,32510,851974,3.815844145478618,96.18415585452138
GA,1961,90769,186255,298313,0,78025,653362,11.942078051677324,88.05792194832267
HI,1961,0,0,113496,0,83,113579,0.07307688921367507,99.92692311078632
IA,1961,104513,211826,276695,0,9222,602256,1.5312425280943651,98.46875747190563
ID,1961,17103,24808,77658,0,29904,149473,20.00628876118095,79.99371123881905
IL,1961,899157,576551,1102481,6144,30809,2615142,1.1781004626135025,98.8218995373865
IN,1961,798090,248273,593230,0,23426,1663019,1.4086429559734435,98.59135704402655
KS,1961,13478,364020,253398,0,3739,634635,0.5891575472515698,99.41084245274843
KY,1961,288113,156328,199248,0,30224,673913,4.48485190224851,95.51514809775149
LA,1961,1,1064610,469790,0,37174,1571575,2.365397769753273,97.63460223024673
MA,1961,120459,84630,823920,9931,46881,1085821,4.317562471162374,95.68243752883762
MD,1961,230214,76520,348191,0,27478,682403,4.026652872276353,95.97334712772364
ME,1961,19505,0,168340,0,37729,225574,16.72577513365902,83.27422486634097
MI,1961,637466,422582,715745,0,42271,1818064,2.3250556636070017,97.674944336393
MN,1961,130948,199324,374735,0,27142,732149,3.7071688959487754,96.29283110405123
MO,1961,158523,284094,403064,0,36095,881776,4.093443232748453,95.90655676725154
MS,1961,655,190591,142103,0,45532,378881,12.017493619368615,87.98250638063139
MT,1961,5149,61314,116813,0,29514,212790,13.870012688566192,86.12998731143381
NC,1961,244241,52291,441038,0,86520,824090,10.498853280588285,89.50114671941172
ND,1961,30011,29310,96651,0,5238,161210,3.2491780906891634,96.75082190931084
NE,1961,18164,144566,138374,0,6114,307218,1.990117766537117,98.00988223346289
NH,1961,12308,3124,88309,0,14720,118461,12.42603050793088,87.57396949206912
NJ,1961,193959,159189,969056,0,20614,1342818,1.5351298537850997,98.4648701462149
NM,1961,3303,218948,107071,0,6560,335882,1.953066850858337,98.04693314914167
NV,1961,3740,16419,62004,0,6893,89056,7.740073661516349,92.25992633848365
NY,1961,634013,450630,1817656,0,119407,3021706,3.951641887066445,96.04835811293356
OH,1961,1159286,746456,770467,0,36264,2712473,1.336934966725936,98.66306503327407
OK,1961,1452,316051,257686,0,12937,588126,2.1996987040192066,97.80030129598079
OR,1961,9420,35011,218420,0,98494,361345,27.257606996084075,72.74239300391592
PA,1961,1431872,547651,1100989,3548,50343,3134403,1.6061431794188559,98.39385682058115
RI,1961,15116,13227,136939,0,2953,168235,1.7552827889559248,98.24471721104408
SC,1961,103498,63060,222199,0,52845,441602,11.966657759702175,88.03334224029783
SD,1961,6273,26724,87074,0,5345,125416,4.261816674108567,95.73818332589143
TN,1961,354174,166703,236525,0,73329,830731,8.827045096427122,91.17295490357287
TX,1961,18203,2831993,1555772,0,43091,4449059,0.9685418871720964,99.0314581128279
UT,1961,81964,79168,126702,0,2920,290754,1.0042854096590246,98.99571459034098
VA,1961,328073,73034,429518,0,57891,888516,6.515470739975419,93.48452926002459
VT,1961,3906,0,50463,0,9783,64152,15.249719416386084,84.75028058361391
WA,1961,15709,72805,363073,0,185353,636940,29.100543222281534,70.89945677771847
WI,1961,307795,117658,390600,0,46016,862069,5.337855786485768,94.66214421351422
WV,1961,386400,168291,131972,0,16121,702784,2.2938769237774337,97.70612307622257
WY,1961,20100,59326,81242,0,3694,164362,2.24747812754773,97.75252187245226
US,1961,9618013,12926392,20168040,19678,1825773,44557896,4.0975296499637235,95.90247035003628
AK,1962,13559,4048,53752,0,5283,76642,6.893087341144542,93.10691265885546
AL,1962,427177,201250,239387,0,71684,939498,7.630032208690173,92.36996779130983
AR,1962,160,235477,166202,0,40059,441898,9.065214144440572,90.93478585555943
AZ,1962,6291,163461,135742,0,13645,319139,4.275566445968685,95.72443355403132
CA,1962,39681,1483423,1879327,84,165152,3567667,4.62913158655222,95.37086841344778
CO,1962,79296,202310,183671,0,9886,475163,2.0805492010110216,97.91945079898898
CT,1962,112064,33355,378744,0,13830,537993,2.5706654175797827,97.42933458242021
DC,1962,22437,14742,58579,0,125,95883,0.13036721838073487,99.86963278161926
DE,1962,22586,14999,122925,0,5134,165644,3.099418029026104,96.9005819709739
FL,1962,39644,162843,715541,0,34131,952159,3.5845903887901076,96.4154096112099
GA,1962,87199,199380,327690,0,78468,692737,11.327242517723176,88.67275748227682
HI,1962,0,0,108072,0,69,108141,0.06380558715010957,99.93619441284989
IA,1962,114293,221026,284716,0,8926,628961,1.419165894228736,98.58083410577126
ID,1962,18028,26709,81066,0,31236,157039,19.890600424098473,80.10939957590153
IL,1962,912473,624035,1116454,13870,31511,2698343,1.1677907515834718,98.83220924841653
IN,1962,785052,281781,603338,0,23550,1693721,1.3904297106784411,98.60957028932155
KS,1962,14595,373666,264169,0,3561,655991,0.5428428133922569,99.45715718660774
KY,1962,287376,163826,222878,0,31596,705676,4.477408895867225,95.52259110413277
LA,1962,0,1050301,489667,0,36785,1576753,2.332958935229551,97.66704106477044
MA,1962,119907,92131,844011,8017,47937,1112003,4.310869664919969,95.68913033508004
MD,1962,252310,84796,369692,0,27796,734594,3.783858839032173,96.21614116096782
ME,1962,17821,0,163744,0,37615,219180,17.16169358518113,82.83830641481887
MI,1962,695978,459179,739170,0,41564,1935891,2.147021707317199,97.8529782926828
MN,1962,131206,221625,391131,0,27479,771441,3.562035204247635,96.43796479575236
MO,1962,180520,299614,420475,0,33947,934556,3.6324201010961357,96.36757989890387
MS,1962,708,199391,155263,0,44673,400035,11.167272863624433,88.83272713637557
MT,1962,5670,65680,120089,0,29088,220527,13.190221605517692,86.80977839448231
NC,1962,260487,58346,462642,0,88160,869635,10.137586458686691,89.86241354131332
ND,1962,28384,32045,104594,0,4815,169838,2.835054581424652,97.16494541857534
NE,1962,23047,149324,141446,0,6003,319820,1.876993308736164,98.12300669126384
NH,1962,12330,3431,94812,0,15416,125989,12.235988856169984,87.76401114383002
NJ,1962,195944,180307,1039261,0,21038,1436550,1.46448087431694,98.53551912568307
NM,1962,2451,247090,114724,0,6336,370601,1.7096553975839246,98.29034460241607
NV,1962,4218,18141,67559,0,7640,97558,7.83123885278501,92.168761147215
NY,1962,620891,491055,1883701,706,128633,3124986,4.116274440909495,95.88372555909051
OH,1962,1229713,784630,805616,0,36861,2856820,1.2902808017305956,98.70971919826941
OK,1962,1072,416403,273079,0,11435,701989,1.6289429036637326,98.37105709633627
OR,1962,8805,39190,228614,0,102510,379119,27.039003584626464,72.96099641537354
PA,1962,1477609,568742,1146054,3717,50913,3247035,1.5679843303198149,98.43201566968018
RI,1962,14953,14277,142184,0,3100,174514,1.7763617818627733,98.22363821813722
SC,1962,108500,73118,241045,0,51541,474204,10.868950915639683,89.13104908436031
SD,1962,6725,28372,90393,0,6520,132010,4.939019771229452,95.06098022877055
TN,1962,347170,173967,253947,0,76268,851352,8.9584566665727,91.0415433334273
TX,1962,20582,2959563,1633869,0,42005,4656019,0.9021655624687098,99.09783443753129
UT,1962,65575,87938,136636,0,3384,293533,1.1528516384869845,98.84714836151302
VA,1962,345482,79884,441746,0,58653,925765,6.33562513164788,93.66437486835213
VT,1962,3019,0,52473,0,9975,65467,15.236684130936197,84.7633158690638
WA,1962,15652,84281,373247,0,194038,667218,29.081649475883445,70.91835052411656
WI,1962,310326,141294,404321,0,46422,902363,5.1444928482218355,94.85550715177817
WV,1962,391870,159207,139292,0,16329,706698,2.3106050958117894,97.6893949041882
WY,1962,23749,61189,90729,0,4776,180443,2.646819217148906,97.3531807828511
US,1962,9904585,13730841,20997481,26394,1887502,46546803,4.055062600110259,95.94493739988974
AK,1963,11999,5567,55429,0,5493,78488,6.998522067067578,93.00147793293242
AL,1963,442465,211348,251791,0,67547,973151,6.941060534285018,93.05893946571499
AR,1963,135,252846,172970,0,38411,464362,8.271779344563077,91.72822065543693
AZ,1963,8432,169533,144241,0,14064,336270,4.18235346596485,95.81764653403515
CA,1963,46127,1623370,1915789,2288,180034,3767608,4.778469522306992,95.22153047769301
CO,1963,88958,180366,189938,0,10099,469361,2.151648730934185,97.84835126906582
CT,1963,117384,35575,380064,0,14287,547310,2.6104036103853394,97.38959638961467
DC,1963,18598,15335,60510,0,119,94562,0.1258433620270299,99.87415663797297
DE,1963,26494,17082,128087,0,5356,177019,3.025663911783481,96.97433608821652
FL,1963,43281,179441,735066,0,36741,994529,3.6943115786467766,96.30568842135322
GA,1963,115509,195667,343066,0,82421,736663,11.188426729725805,88.8115732702742
HI,1963,0,0,113818,0,284,114102,0.24890010692187692,99.75109989307812
IA,1963,116201,220538,290839,0,8046,635624,1.265842699457541,98.73415730054246
ID,1963,16589,28366,79238,0,30959,155152,19.953980612560585,80.04601938743942
IL,1963,912344,655743,1146719,11093,33167,2759066,1.2021096994417677,98.79789030055824
IN,1963,815496,297815,615254,0,23640,1752205,1.3491572047791212,98.65084279522088
KS,1963,16716,367759,268945,0,3681,657101,0.5601878554438359,99.43981214455616
KY,1963,368036,173508,228153,0,31134,800831,3.8877116395344338,96.11228836046557
LA,1963,2,1128773,578993,0,39147,1746915,2.2409218536677513,97.75907814633224
MA,1963,115969,99924,810041,11181,47754,1084869,4.401821786777942,95.59817821322206
MD,1963,275328,89004,373975,0,28595,766902,3.728638078920123,96.27136192107987
ME,1963,12541,0,168899,0,38725,220165,17.58908091658529,82.41091908341471
MI,1963,758970,470503,752116,1453,41693,2024735,2.05918305358479,97.94081694641521
MN,1963,138716,218609,397851,8,26381,781565,3.375407035883132,96.62459296411687
MO,1963,180670,309137,430599,0,30636,951042,3.2213088380954784,96.77869116190452
MS,1963,763,222937,173232,0,39154,436086,8.978504239989359,91.02149576001064
MT,1963,5372,66566,121231,0,27929,221098,12.631955060651837,87.36804493934817
NC,1963,282911,64539,467240,0,85633,900323,9.511364254828544,90.48863574517145
ND,1963,24937,32283,110136,0,5429,172785,3.142055155250745,96.85794484474926
NE,1963,24513,145771,151176,886,6032,328378,1.8369074663954346,98.16309253360457
NH,1963,11520,3607,98991,0,15334,129452,11.84531718320304,88.15468281679696
NJ,1963,193035,197097,1062840,0,23285,1476257,1.5772998874857156,98.42270011251428
NM,1963,15765,239911,117912,0,6161,379749,1.622387419058378,98.37761258094162
NV,1963,3387,20681,71529,0,7049,102646,6.867291467762991,93.132708532237
NY,1963,643946,520712,1902730,7017,123205,3197610,3.853033984757366,96.14696601524264
OH,1963,1243806,826138,821093,0,38113,2929150,1.3011624532714268,98.69883754672857
OK,1963,1685,490988,283258,0,9292,785223,1.1833581033668144,98.81664189663319
OR,1963,7455,46731,235270,0,102818,392274,26.21076084573538,73.78923915426462
PA,1963,1538471,609513,1174614,4221,51746,3378565,1.5315969945820194,98.46840300541798
RI,1963,13308,15343,140204,0,3195,172050,1.8570183086312118,98.14298169136879
SC,1963,118239,78478,245215,0,50928,492860,10.333157488942094,89.66684251105791
SD,1963,6221,25084,94732,0,11217,137254,8.17243941888761,91.8275605811124
TN,1963,386275,179197,263331,0,72432,901235,8.036971489123259,91.96302851087674
TX,1963,19173,3044428,1812971,0,39339,4915911,0.8002382467868112,99.1997617532132
UT,1963,62411,88494,136195,0,3210,290310,1.1057145809651752,98.89428541903483
VA,1963,360181,86240,468650,0,58080,973151,5.968241310957909,94.03175868904209
VT,1963,3352,0,52519,0,9119,64990,14.031389444529928,85.96861055547008
WA,1963,13194,93433,379869,0,209427,695923,30.09341550717536,69.90658449282463
WI,1963,319255,156163,410815,0,44151,930384,4.745459939121911,95.25454006087809
WV,1963,438083,163925,129969,0,15363,747340,2.0556908502154307,97.94430914978457
WY,1963,30292,55041,86377,0,4428,176138,2.5139379350282165,97.48606206497179
US,1963,10414512,14419107,21644489,38147,1900483,48416738,3.925260309771385,96.07473969022861
AK,1964,12029,6805,58130,0,5828,82792,7.039327471253261,92.96067252874674
AL,1964,459000,230316,256646,0,76231,1022193,7.4575936246873145,92.54240637531268
AR,1964,186,278852,184126,0,38775,501939,7.725042286014834,92.27495771398516
AZ,1964,9103,174623,147476,0,13932,345134,4.036692994604994,95.96330700539501
CA,1964,53723,1817241,2027468,4369,174530,4077331,4.280496236386008,95.71950376361399
CO,1964,89600,205251,195500,0,10420,500771,2.080791419630929,97.91920858036907
CT,1964,120798,38627,389732,0,14805,563962,2.6251768736191448,97.37482312638086
DC,1964,18111,16266,70175,0,104,104656,0.09937318452835958,99.90062681547164
DE,1964,29241,17826,125502,0,5510,178079,3.09413237944957,96.90586762055042
FL,1964,46691,189595,770772,0,36972,1044030,3.541277549495704,96.4587224505043
GA,1964,123813,215579,359649,0,87913,786954,11.171300990909252,88.82869900909074
HI,1964,0,0,122004,0,617,122621,0.5031764542778154,99.49682354572218
IA,1964,112797,244609,291326,0,7934,656666,1.208224576877743,98.79177542312226
ID,1964,18234,33014,84040,0,32529,167817,19.383614294141832,80.61638570585816
IL,1964,944485,737326,1163221,11710,33237,2889979,1.150077561117226,98.84992243888277
IN,1964,860401,333685,620329,0,22850,1837265,1.2436964727461743,98.75630352725382
KS,1964,14827,391306,262682,0,3580,672395,0.5324251370102395,99.46757486298976
KY,1964,401711,179666,234448,0,29999,845824,3.546718939164649,96.45328106083535
LA,1964,1,1201445,626747,0,39291,1867484,2.1039537688140837,97.89604623118592
MA,1964,123421,108193,838538,14166,49424,1133742,4.359369239209626,95.64063076079037
MD,1964,300629,94255,391581,0,29601,816066,3.6272801464587423,96.37271985354126
ME,1964,8082,0,177055,0,38510,223647,17.21909974200414,82.78090025799585
MI,1964,780945,505780,762674,2293,41873,2093565,2.000081201204644,97.99991879879536
MN,1964,156354,236502,401486,669,26549,821560,3.2315351282925167,96.76846487170748
MO,1964,183420,332023,437130,0,28979,981552,2.952365233833765,97.04763476616624
MS,1964,729,250528,180787,0,38448,470492,8.171871147649695,91.8281288523503
MT,1964,5811,69486,123327,0,31292,229916,13.610188068685956,86.38981193131404
NC,1964,295013,70932,473652,0,89520,929117,9.63495447828422,90.36504552171579
ND,1964,26502,33390,109579,0,6775,176246,3.8440588722580937,96.15594112774191
NE,1964,23650,160545,147140,1082,5732,338149,1.6951107352084436,98.30488926479156
NH,1964,11755,3817,97142,0,15585,128299,12.147405669568741,87.85259433043126
NJ,1964,206555,209714,1079414,0,23810,1519493,1.5669700353999656,98.43302996460004
NM,1964,31271,226697,125717,0,6233,389918,1.598541231746162,98.40145876825383
NV,1964,3234,25579,75647,0,6445,110905,5.811279924259502,94.1887200757405
NY,1964,739638,527890,1888516,4555,119068,3279667,3.6304905345573193,96.36950946544268
OH,1964,1272289,852659,858117,207,37942,3021214,1.2558527797104078,98.74414722028959
OK,1964,1035,522805,286214,0,9214,819268,1.1246625036007754,98.87533749639923
OR,1964,6833,57979,249225,0,110005,424042,25.942005744713967,74.05799425528603
PA,1964,1699047,632666,1193781,301,51558,3577353,1.4412332246775759,98.55876677532243
RI,1964,11022,16145,135069,0,3505,165741,2.1147452953704877,97.88525470462952
SC,1964,108707,82101,231493,468,56855,479624,11.854077360599137,88.14592263940087
SD,1964,5539,27528,94639,0,11830,139536,8.478098841875932,91.52190115812407
TN,1964,336101,191178,273631,0,77432,878342,8.815700490241841,91.18429950975816
TX,1964,26232,3040492,1933568,0,40685,5040977,0.8070856105869954,99.192914389413
UT,1964,71031,99071,136680,0,4758,311540,1.5272517172754703,98.47274828272452
VA,1964,370395,91963,479118,0,57524,999000,5.7581581581581585,94.24184184184185
VT,1964,2730,0,49575,0,8820,61125,14.429447852760736,85.57055214723927
WA,1964,11827,113935,393136,0,225740,744638,30.315401577679356,69.68459842232065
WI,1964,333408,173946,410726,0,44178,962258,4.591076405704084,95.40892359429591
WV,1964,467210,172374,130542,0,15290,785416,1.946739052935005,98.053260947065
WY,1964,32379,55437,85379,0,4449,177644,2.5044470964400714,97.49555290355993
US,1964,10967543,15297642,22240249,39819,1952686,50497939,3.8668627644387628,96.13313723556124
AK,1965,9888,7670,61705,0,6057,85320,7.09915611814346,92.90084388185655
AL,1965,533142,236949,261907,0,71876,1103874,6.511250378213456,93.48874962178654
AR,1965,163,277661,178998,0,38819,495641,7.832080074085881,92.16791992591412
AZ,1965,7030,166063,145724,0,18841,337658,5.579906295719337,94.42009370428066
CA,1965,63693,1813213,2089816,3193,202276,4172191,4.848196067725567,95.15180393227443
CO,1965,98117,204483,198500,0,9768,510868,1.9120399007179938,98.087960099282
CT,1965,128613,41720,386912,0,14180,571425,2.4815155094719343,97.51848449052807
DC,1965,13804,17315,92330,0,98,123547,0.07932203938582078,99.92067796061419
DE,1965,29030,18742,133710,0,5577,187059,2.9814122816865267,97.01858771831347
FL,1965,55189,191669,822724,0,37816,1107398,3.4148517515834413,96.58514824841656
GA,1965,152600,219774,390399,0,85250,848023,10.05279337942485,89.94720662057514
HI,1965,0,0,129295,0,529,129824,0.4074747350258812,99.59252526497411
IA,1965,126638,249988,293900,0,8628,679154,1.2704040615236014,98.7295959384764
ID,1965,15863,36092,86807,0,33020,171782,19.222037233237476,80.77796276676253
IL,1965,1014492,778662,1216922,11393,33805,3055274,1.1064474086448548,98.89355259135515
IN,1965,900562,357502,647426,0,22400,1927890,1.1618920166607016,98.8381079833393
KS,1965,15282,440802,276842,0,3404,736330,0.46229272201322774,99.53770727798677
KY,1965,415492,176734,255784,0,30086,878096,3.4262768535558754,96.57372314644412
LA,1965,0,1156449,637032,0,38299,1831780,2.09080784810403,97.90919215189597
MA,1965,127922,115712,956316,11407,50963,1262320,4.037248875087141,95.96275112491286
MD,1965,327393,100979,410242,0,30986,869600,3.563247470101196,96.4367525298988
ME,1965,7992,0,171429,0,37108,216529,17.13765823515557,82.86234176484443
MI,1965,830191,563563,791646,2132,43091,2230623,1.9317921495474584,98.06820785045254
MN,1965,159987,248244,424101,1693,27094,861119,3.1463711751802017,96.8536288248198
MO,1965,189620,347967,461941,0,29755,1029283,2.8908473179873755,97.10915268201262
MS,1965,1020,250626,174275,0,37759,463680,8.143331608005521,91.85666839199448
MT,1965,5537,70795,110675,0,36437,223444,16.30699414618428,83.69300585381572
NC,1965,325866,78245,494612,0,85689,984412,8.704587103773623,91.29541289622638
ND,1965,24746,32437,106897,0,8854,172934,5.119872321232378,94.88012767876762
NE,1965,20815,164719,140541,-64,5708,331719,1.7207335124005558,98.27926648759944
NH,1965,11171,4133,96289,0,14607,126200,11.574484944532488,88.42551505546751
NJ,1965,236647,219196,1072225,0,23912,1551980,1.54074150440083,98.45925849559917
NM,1965,44277,224253,127993,0,5773,402296,1.4350130252351503,98.56498697476485
NV,1965,7892,29395,69877,0,6317,113481,5.5665706153453005,94.4334293846547
NY,1965,755238,558658,2109451,8585,124906,3556838,3.511714618433564,96.48828538156644
OH,1965,1324406,909391,917461,255,38645,3190158,1.2113820067846168,98.78861799321538
OK,1965,697,480079,294406,0,10422,785604,1.3266225732048207,98.67337742679518
OR,1965,7110,59990,248291,0,114175,429566,26.579151981302058,73.42084801869794
PA,1965,1751318,652906,1245912,3691,51907,3705734,1.4007211526785246,98.59927884732147
RI,1965,11461,17036,127459,0,3549,159505,2.2250086204194224,97.77499137958058
SC,1965,121474,90513,224469,880,52586,489922,10.733545339870428,89.26645466012957
SD,1965,5652,26884,89989,0,14330,136855,10.470936392532241,89.52906360746776
TN,1965,338853,211142,291325,0,76396,917716,8.324579717472508,91.6754202825275
TX,1965,29182,3181456,1963246,0,43732,5217616,0.8381605698847903,99.16183943011521
UT,1965,75449,99810,142231,0,5072,322562,1.5724108853491732,98.42758911465083
VA,1965,386296,98615,513562,0,57219,1055692,5.420046756061427,94.57995324393858
VT,1965,2707,0,58909,0,9368,70984,13.197340245689169,86.80265975431082
WA,1965,12134,116216,405793,0,234444,768587,30.503248168392126,69.49675183160787
WI,1965,347925,204093,412265,0,46685,1010968,4.61785140578139,95.3821485942186
WV,1965,477365,176111,136937,0,14729,805142,1.8293667452449383,98.17063325475506
WY,1965,34454,54805,86464,0,4567,180290,2.5331410505297023,97.46685894947029
US,1965,11582398,15779457,23183963,43164,2007517,52596499,3.816826287240145,96.18317371275985
AK,1966,16431,12282,65655,0,6114,100482,6.084671881531021,93.91532811846898
AL,1966,583457,240755,272450,0,72734,1169396,6.219792097800916,93.78020790219908
AR,1966,111,289632,194561,0,40584,524888,7.731935193793723,92.26806480620628
AZ,1966,7373,174448,159220,0,21495,362536,5.929066354789593,94.0709336452104
CA,1966,51515,1982305,2219598,1895,190831,4446144,4.292056217702351,95.70794378229765
CO,1966,109021,207693,212419,0,10388,539521,1.9254116151178546,98.07458838488215
CT,1966,136198,48744,412430,0,14474,611846,2.3656279521317454,97.63437204786825
DC,1966,23936,17611,93935,0,95,135577,0.07007088222928667,99.92992911777071
DE,1966,38690,19845,135477,0,5852,199864,2.927991033903054,97.07200896609694
FL,1966,70146,220568,843702,0,40729,1175145,3.465870169213161,96.53412983078684
GA,1966,177237,243089,413509,0,86062,919897,9.355612639241132,90.64438736075887
HI,1966,0,0,144166,0,525,144691,0.362842194746045,99.63715780525395
IA,1966,125400,244028,317679,0,8921,696028,1.2817013108668043,98.71829868913319
ID,1966,14867,38992,87936,0,33565,175360,19.140625,80.859375
IL,1966,1072076,868621,1232038,16358,35866,3224959,1.112138169818593,98.88786183018141
IN,1966,967518,399896,659189,0,23649,2050252,1.1534679639380916,98.8465320360619
KS,1966,13680,481093,279358,0,3436,777567,0.44189118108150166,99.5581088189185
KY,1966,426294,152219,281670,0,31345,891528,3.5158738704785493,96.48412612952146
LA,1966,0,1245597,695295,0,39754,1980646,2.0071229285798675,97.99287707142014
MA,1966,112103,117709,969386,12572,52491,1264261,4.151911670137733,95.84808832986226
MD,1966,339046,102826,432553,0,32846,907271,3.6203074935713806,96.37969250642863
ME,1966,7401,522,180137,0,38863,226923,17.12607360205885,82.87392639794115
MI,1966,897159,626782,824626,3983,44084,2396634,1.8394131102204174,98.16058688977958
MN,1966,171398,265810,450411,1498,26728,915845,2.9183977638137457,97.08160223618626
MO,1966,190661,357396,476235,0,28835,1053127,2.738036343195075,97.26196365680492
MS,1966,898,284500,185309,0,37816,508523,7.436438469843055,92.56356153015695
MT,1966,5805,72116,118225,0,34729,230875,15.042338927991338,84.95766107200866
NC,1966,380312,89442,535629,0,83671,1089054,7.682906449083333,92.31709355091667
ND,1966,36034,31864,112532,0,6914,187344,3.6905371936117515,96.30946280638825
NE,1966,19748,195864,151343,0,5814,372769,1.559679050564827,98.44032094943518
NH,1966,9655,4197,108409,0,15750,138011,11.41213381542051,88.5878661845795
NJ,1966,236575,236816,1152190,0,24491,1650072,1.4842382635424394,98.51576173645756
NM,1966,37029,247390,126340,0,5735,416494,1.3769706166235287,98.62302938337648
NV,1966,10862,36305,72019,0,7021,126207,5.563082871789995,94.43691712821
NY,1966,731385,645684,2220867,9274,134028,3741238,3.582450515043416,96.41754948495658
OH,1966,1420418,975841,940071,17,41464,3377811,1.2275405580714847,98.77245944192852
OK,1966,695,449319,303667,0,9477,763158,1.2418136218188107,98.7581863781812
OR,1966,6521,69324,262945,0,115562,454352,25.434464908264957,74.56553509173504
PA,1966,1746453,702888,1284932,6107,53572,3793952,1.4120368417945193,98.58796315820548
RI,1966,10581,17385,127158,0,3757,158881,2.3646628608833025,97.6353371391167
SC,1966,132867,100873,243173,852,49417,527182,9.373802595688018,90.62619740431198
SD,1966,5239,28256,93476,105,17608,144684,12.169970418290896,87.8300295817091
TN,1966,363659,236752,325849,0,75178,1001438,7.507004926915096,92.4929950730849
TX,1966,27844,3404262,2078723,0,46470,5557299,0.8361975844740404,99.16380241552596
UT,1966,79119,95740,154284,0,4636,333779,1.3889429832314195,98.61105701676858
VA,1966,386377,125287,533921,0,58708,1104293,5.316342673547691,94.6836573264523
VT,1966,2198,906,64284,0,9674,77062,12.55352832783992,87.44647167216007
WA,1966,11134,124827,432260,11497,247337,827055,29.9057499198965,70.0942500801035
WI,1966,370695,229393,430383,0,46522,1076993,4.319619533274589,95.68038046672541
WV,1966,520023,179195,140775,0,14729,854722,1.7232503667859258,98.27674963321408
WY,1966,41450,62891,82040,0,4645,191026,2.4316061687937767,97.56839383120622
US,1966,12145291,17005781,24334435,64158,2044990,55594655,3.678393183661271,96.32160681633873
AK,1967,18462,11889,76363,0,5910,112624,5.2475493678079275,94.75245063219208
AL,1967,580163,262055,277348,0,80231,1199797,6.687047892268442,93.31295210773156
AR,1967,104,295756,200031,0,37500,533391,7.030489828287316,92.96951017171268
AZ,1967,7184,169085,167963,0,21267,365499,5.818620570781316,94.18137942921868
CA,1967,53949,2048734,2251677,6503,223328,4584191,4.871699281290853,95.12830071870914
CO,1967,107862,210209,231730,0,10391,560192,1.854899748657603,98.1451002513424
CT,1967,109548,50826,445943,6056,15308,627681,2.438818444400898,97.5611815555991
DC,1967,22600,21923,102383,0,96,147002,0.06530523394239535,99.9346947660576
DE,1967,40712,21948,125888,0,5783,194331,2.975850481909731,97.02414951809027
FL,1967,96160,234326,847255,0,42543,1220284,3.486319578065434,96.51368042193457
GA,1967,165942,265271,454111,0,83470,968794,8.61586673740754,91.38413326259246
HI,1967,0,0,162476,0,628,163104,0.38503041004512456,99.61496958995488
IA,1967,120832,278580,331001,0,8584,738997,1.1615744042262688,98.83842559577373
ID,1967,13401,35929,104391,0,33833,187554,18.039071414099407,81.96092858590059
IL,1967,1030722,979649,1283202,9325,36183,3339081,1.083621511427845,98.91637848857215
IN,1967,930848,434632,657294,0,24073,2046847,1.1761015845346525,98.82389841546535
KS,1967,12231,446454,282028,0,3284,743997,0.4413996292995805,99.55860037070042
KY,1967,434203,197083,292795,0,35123,959204,3.661681977973403,96.3383180220266
LA,1967,0,1440390,750617,0,37685,2228692,1.690902107603922,98.30909789239608
MA,1967,101438,129884,1042398,14707,52573,1341000,3.920432513049963,96.07956748695004
MD,1967,350715,121287,412949,0,36000,920951,3.9090027591044474,96.09099724089555
ME,1967,5618,775,193495,0,40369,240257,16.802424070890755,83.19757592910925
MI,1967,870628,699131,845652,5801,42707,2463919,1.733295615643209,98.26670438435679
MN,1967,161175,285350,433071,1624,26329,907549,2.9011105736439573,97.09888942635604
MO,1967,188991,367195,494891,0,27056,1078133,2.5095234075944246,97.49047659240557
MS,1967,962,288650,207865,0,34261,531738,6.4432107541684065,93.5567892458316
MT,1967,5484,64908,111571,0,37055,219018,16.9187007460574,83.0812992539426
NC,1967,405418,100822,547089,0,83266,1136595,7.325916443412122,92.67408355658787
ND,1967,44028,32049,116513,0,9804,202394,4.844017115131871,95.15598288486812
NE,1967,18303,187907,158852,0,5713,370775,1.5408266468882745,98.45917335311172
NH,1967,10247,4522,112063,0,15648,142480,10.98259404828748,89.01740595171252
NJ,1967,198642,261542,1252470,0,25111,1737765,1.4450170189870322,98.55498298101297
NM,1967,44143,280382,125949,0,5432,455906,1.1914736809780964,98.80852631902191
NV,1967,9379,36822,75859,0,6823,128883,5.293948775245766,94.70605122475423
NY,1967,726567,602670,2354677,13321,137102,3834337,3.5756377178114493,96.42436228218855
OH,1967,1405472,994595,949735,0,39598,3389400,1.1682893727503394,98.83171062724966
OK,1967,567,460163,313611,0,9509,783850,1.2131147540983607,98.78688524590164
OR,1967,4802,73999,262509,0,117729,459039,25.646840464535693,74.3531595354643
PA,1967,1701151,701546,1308614,6968,54815,3773094,1.4527864929948737,98.54721350700513
RI,1967,6545,19251,147508,0,4113,177417,2.31826713336377,97.68173286663622
SC,1967,134348,104561,245391,94,47544,531938,8.937883738330408,91.06211626166959
SD,1967,5553,27846,92614,770,17970,144753,12.414250481855298,87.5857495181447
TN,1967,351990,241965,332976,0,79710,1006641,7.918413813862141,92.08158618613786
TX,1967,23523,3638596,2175645,0,45877,5883641,0.7797382607130516,99.22026173928695
UT,1967,72396,97068,151592,0,5725,326781,1.751937842163406,98.2480621578366
VA,1967,369977,119364,555985,0,56115,1101441,5.094689592996811,94.90531040700318
VT,1967,2059,1374,63731,0,9448,76612,12.332271706782228,87.66772829321778
WA,1967,8265,135245,447725,23287,264572,879094,30.095985184747022,69.90401481525298
WI,1967,360809,253737,459141,0,46455,1120142,4.147242046097727,95.85275795390227
WV,1967,543103,157423,140768,0,15102,856396,1.7634365410394257,98.23656345896057
WY,1967,39826,69619,95114,0,4103,208662,1.9663379053205663,98.03366209467943
US,1967,11917043,17964988,25272517,88456,2108853,57351857,3.677043970869156,96.32295602913085
AK,1968,15998,17636,80412,0,5946,119992,4.955330355357024,95.04466964464298
AL,1968,618335,296690,306563,0,78106,1299694,6.009568406101744,93.99043159389825
AR,1968,132,321569,219831,0,43993,585525,7.513428120063191,92.4865718799368
AZ,1968,8137,189965,188622,0,23609,410333,5.753619621136979,94.24638037886302
CA,1968,57011,2187260,2403681,17003,204480,4869435,4.199255149724762,95.80074485027524
CO,1968,112995,253481,251339,0,10654,628469,1.6952307910175364,98.30476920898246
CT,1968,82430,54053,485914,33941,16154,672492,2.402110359677141,97.59788964032286
DC,1968,23692,22957,108713,0,110,155472,0.07075228980137903,99.92924771019862
DE,1968,44082,25069,134583,0,6592,210326,3.1341821743388834,96.86581782566111
FL,1968,103172,286653,916508,0,47868,1354201,3.5347780720882644,96.46522192791174
GA,1968,194909,295289,488707,0,84378,1063283,7.935610745210823,92.06438925478918
HI,1968,0,0,181142,0,999,182141,0.5484761805414486,99.45152381945856
IA,1968,120036,303746,341249,0,9599,774630,1.2391722499774085,98.76082775002259
ID,1968,11552,40387,110706,0,33676,196321,17.153539356462122,82.84646064353788
IL,1968,1006199,1027219,1380821,10380,38867,3463486,1.1221930736835661,98.87780692631644
IN,1968,961526,454467,701445,0,25019,2142457,1.1677713951785262,98.83222860482148
KS,1968,12740,490591,300262,0,3388,806981,0.4198364025918826,99.58016359740812
KY,1968,444142,201137,319352,0,32913,997544,3.299403334589752,96.70059666541025
LA,1968,0,1539750,820845,0,40791,2401386,1.6986440330709016,98.3013559669291
MA,1968,87696,133913,1084064,13757,56632,1376062,4.115512237093968,95.88448776290603
MD,1968,362795,129702,439115,0,36514,968126,3.771616504463262,96.22838349553673
ME,1968,4592,819,204211,0,41601,251223,16.559391456992394,83.44060854300761
MI,1968,933607,711046,899703,4808,42959,2592123,1.6572901826032176,98.34270981739678
MN,1968,150563,315017,471719,167,26795,964261,2.778811960662103,97.2211880393379
MO,1968,212261,372856,544102,0,29769,1158988,2.5685339278750083,97.43146607212499
MS,1968,7317,319377,234518,0,35452,596664,5.941702532748749,94.05829746725125
MT,1968,6719,62835,124354,0,38298,232206,16.493113873026537,83.50688612697347
NC,1968,446588,117794,565296,0,84154,1213832,6.932919876885763,93.06708012311424
ND,1968,48467,33317,122200,0,8879,212863,4.17122750313582,95.82877249686418
NE,1968,17192,202938,177862,0,5952,403944,1.4734715703166776,98.52652842968332
NH,1968,22297,4208,116297,0,16739,159541,10.491973849982136,89.50802615001787
NJ,1968,188734,278430,1311960,0,27067,1806191,1.4985679809056738,98.50143201909432
NM,1968,42971,286329,143512,0,5406,478218,1.1304467836844285,98.86955321631557
NV,1968,14582,39177,84601,0,6917,145277,4.761249199804511,95.23875080019549
NY,1968,700146,653282,2416843,12131,145503,3927905,3.7043411182296926,96.29565888177031
OH,1968,1478634,1018464,1023914,0,43406,3564418,1.2177584110505557,98.78224158894945
OK,1968,465,507884,337999,0,12744,859092,1.4834266877121425,98.51657331228786
OR,1968,3898,83504,281035,0,128897,497334,25.917592603763264,74.08240739623673
PA,1968,1725890,741600,1377524,5286,54621,3904921,1.39877349631401,98.601226503686
RI,1968,3297,21574,149482,0,4233,178586,2.3702865846146954,97.62971341538531
SC,1968,123989,132104,267320,0,50503,573916,8.799719819625171,91.20028018037483
SD,1968,5218,28959,97836,-30,20425,152408,13.4015274788725,86.5984725211275
TN,1968,439263,243425,360748,0,78078,1121514,6.9618390853792285,93.03816091462078
TX,1968,24996,3836859,2346123,0,53674,6261652,0.8571859311248853,99.14281406887511
UT,1968,73920,101626,161346,0,5686,342578,1.6597679944421417,98.34023200555785
VA,1968,383807,125708,585128,0,58382,1153025,5.063376769801176,94.93662323019882
VT,1968,1884,1674,67645,0,9568,80771,11.845835757883398,88.15416424211661
WA,1968,6977,148065,498738,44091,286795,984666,29.126119922897715,70.87388007710229
WI,1968,356191,278560,475146,0,49123,1159020,4.2383220306810925,95.76167796931891
WV,1968,601879,189957,148069,0,14889,954794,1.559393963514643,98.44060603648536
WY,1968,43608,75649,105759,0,4857,229873,2.1129058219103594,97.88709417808964
US,1968,12337535,19204569,26964864,141534,2191661,60840163,3.602325983248927,96.39767401675107
AK,1969,13191,42940,92045,0,6056,154232,3.926552207064682,96.07344779293531
AL,1969,641466,310822,337296,0,78987,1368571,5.771494500468006,94.22850549953199
AR,1969,0,349990,237000,0,44534,631524,7.051830175891969,92.94816982410804
AZ,1969,8381,210332,201360,0,25112,445185,5.640801015308242,94.35919898469176
CA,1969,60031,2189883,2458067,27127,256255,4991363,5.133968417043601,94.8660315829564
CO,1969,104487,268895,263952,0,11198,648532,1.7266688459474628,98.27333115405254
CT,1969,59211,58405,526530,40166,16712,701024,2.3839412060072123,97.61605879399279
DC,1969,32544,25229,120167,0,106,178046,0.05953517630275322,99.94046482369724
DE,1969,41720,26949,145108,0,7073,220850,3.2026262168892914,96.79737378311071
FL,1969,104100,326855,974967,0,49562,1455484,3.4051903009583064,96.59480969904169
GA,1969,202716,324940,520566,0,83888,1132110,7.409880665306375,92.59011933469363
HI,1969,0,0,189090,0,1070,190160,0.5626840555321834,99.43731594446781
IA,1969,127011,325026,348512,0,9159,809708,1.1311485127972059,98.86885148720279
ID,1969,9853,42389,105973,0,32048,190263,16.84405270599118,83.15594729400883
IL,1969,1012703,1121210,1430597,9111,40517,3614138,1.1210695330394136,98.87893046696058
IN,1969,996123,531512,711119,0,25816,2264570,1.1399956724676208,98.86000432753238
KS,1969,9771,540660,305110,0,3235,858776,0.3766989296393937,99.62330107036061
KY,1969,470838,240050,341218,0,32489,1084595,2.99549601464141,97.0045039853586
LA,1969,0,1784110,885800,0,40698,2710608,1.501434364541092,98.4985656354589
MA,1969,60429,138632,1134960,12614,58415,1405050,4.157503291697805,95.84249670830219
MD,1969,355397,147720,465103,0,35957,1004177,3.5807432355052944,96.4192567644947
ME,1969,4272,1139,216022,0,42215,263648,16.01187947566452,83.98812052433547
MI,1969,908860,788222,941717,4426,43319,2686544,1.6124433472893056,98.3875566527107
MN,1969,191156,328944,498747,0,27125,1045972,2.5932816557230978,97.4067183442769
MO,1969,244510,406671,561646,0,29508,1242335,2.375204755561101,97.6247952444389
MS,1969,14757,333993,253123,0,34609,636482,5.4375457593459045,94.56245424065409
MT,1969,9648,78205,129121,0,39671,256645,15.457538623390287,84.54246137660971
NC,1969,472767,140204,588078,0,84635,1285684,6.582877285553837,93.41712271444617
ND,1969,49996,32944,119620,0,10396,212956,4.881759612314281,95.11824038768572
NE,1969,27082,209613,182782,0,5826,425303,1.3698469091447745,98.63015309085523
NH,1969,26956,5826,129831,0,17690,180303,9.811262153153303,90.18873784684669
NJ,1969,141206,316113,1372768,1182,28018,1859287,1.5069217393549248,98.49307826064508
NM,1969,50226,276591,147150,0,5232,479199,1.0918219779256635,98.90817802207434
NV,1969,16679,46700,87394,0,6803,157576,4.317281819566431,95.68271818043357
NY,1969,656531,698046,2530375,14042,152345,4051339,3.7603616977004393,96.23963830229955
OH,1969,1556077,1063953,1052349,0,44407,3716786,1.1947688137008696,98.80523118629912
OK,1969,144,558754,346039,0,13673,918610,1.4884444976649502,98.51155550233506
OR,1969,3950,92598,293361,0,153969,543878,28.30947381581899,71.69052618418101
PA,1969,1628975,791217,1448627,4579,55361,3928759,1.4091218117476791,98.59087818825232
RI,1969,242,23503,161192,0,4402,189339,2.3249304158150195,97.67506958418498
SC,1969,131995,145896,278432,0,51519,607842,8.475722309415934,91.52427769058407
SD,1969,5503,33995,97755,0,22746,159999,14.216338852117826,85.78366114788217
TN,1969,436716,257524,383337,0,79312,1156889,6.855627462963171,93.14437253703683
TX,1969,25141,4024717,2540573,0,55410,6645841,0.8337545240700162,99.16624547592998
UT,1969,78445,110888,170147,0,6097,365577,1.6677745044135708,98.33222549558643
VA,1969,328714,132739,660544,0,59197,1181194,5.011623831478995,94.988376168521
VT,1969,2074,2391,69754,0,9748,83967,11.609322710112306,88.39067728988769
WA,1969,7065,153481,516487,40475,297673,1015181,29.3221602847177,70.6778397152823
WI,1969,373891,324186,490560,0,47624,1236261,3.85226097078206,96.14773902921795
WV,1969,624054,176295,150546,0,14733,965628,1.5257428326436266,98.47425716735637
WY,1969,55566,96068,109008,0,5274,265916,1.9833330826275968,98.0166669173724
US,1969,12383168,20657964,28321627,153722,2307419,63823900,3.615289883570261,96.38471011642974
AK,1970,13159,64045,95999,0,6267,179470,3.4919485150721568,96.50805148492785
AL,1970,675603,307750,352050,0,78420,1413823,5.546663196170949,94.45333680382905
AR,1970,0,383478,246630,0,41635,671743,6.198054910881096,93.8019450891189
AZ,1970,8623,204383,213298,0,25337,451641,5.609986692970744,94.39001330702925
CA,1970,61812,2241295,2502535,34375,248565,5088582,4.884759644238808,95.11524035576119
CO,1970,115688,274987,273380,0,12579,676634,1.8590552647369183,98.14094473526308
CT,1970,48577,61543,558983,39567,16960,725630,2.337279329685928,97.66272067031407
DC,1970,28427,26402,129410,0,108,184347,0.058585168188253677,99.94141483181174
DE,1970,37238,26949,153982,0,7021,225190,3.1178116257382653,96.88218837426173
FL,1970,116720,350626,1065634,0,48969,1581949,3.095485379111463,96.90451462088853
GA,1970,193155,342834,553586,0,80385,1169960,6.870747717870697,93.1292522821293
HI,1970,0,0,195388,0,796,196184,0.4057415487501529,99.59425845124984
IA,1970,130867,351800,346563,0,9456,838686,1.1274779834169164,98.87252201658309
ID,1970,7935,49411,105159,0,35620,198125,17.978548895899053,82.02145110410095
IL,1970,920303,1203225,1487160,27600,39885,3678173,1.0843698760226885,98.91563012397731
IN,1970,1006824,548640,731101,0,24986,2311551,1.0809192615693966,98.91908073843061
KS,1970,10701,574542,302912,0,3682,891837,0.4128557124227858,99.58714428757722
KY,1970,527054,252265,357631,0,34548,1171498,2.9490447273490865,97.05095527265091
LA,1970,0,1894224,900341,0,41620,2836185,1.4674642168969936,98.532535783103
MA,1970,21393,149074,1240487,13272,59709,1483935,4.023693760171436,95.97630623982856
MD,1970,311292,159584,528914,0,38278,1038068,3.687427027901833,96.31257297209817
ME,1970,2166,1315,230972,0,39213,273666,14.328780338076342,85.67121966192366
MI,1970,828881,821261,955898,4113,42244,2652397,1.5926725901137726,98.40732740988622
MN,1970,179727,343007,512466,0,26493,1061693,2.495354118375086,97.50464588162491
MO,1970,279245,432532,571688,0,26776,1310241,2.0435935068433975,97.9564064931566
MS,1970,13225,369391,272674,0,33527,688817,4.867330510135493,95.13266948986451
MT,1970,12023,90601,126169,0,36465,265258,13.746993493127446,86.25300650687255
NC,1970,491383,154856,618277,0,80822,1345338,6.007560925209873,93.99243907479013
ND,1970,57471,33731,115352,0,9989,216543,4.6129406168751705,95.38705938312484
NE,1970,29716,224114,192242,0,6244,452316,1.3804508352567675,98.61954916474323
NH,1970,27149,6796,139870,0,16544,190359,8.690947105206478,91.30905289479352
NJ,1970,123291,331247,1439875,37917,28760,1961090,1.4665313677597662,98.53346863224023
NM,1970,99380,292522,155743,0,5082,552727,0.9194412431453503,99.08055875685464
NV,1970,17290,56868,90440,0,6667,171265,3.8927977111493886,96.10720228885062
NY,1970,598940,725813,2647016,46908,148081,4166758,3.5538660992551043,96.4461339007449
OH,1970,1571427,1077151,1071430,0,44097,3764105,1.171513547045048,98.82848645295495
OK,1970,154,616279,365166,0,11775,993374,1.1853541566419092,98.8146458433581
OR,1970,3047,99572,294478,0,159510,556607,28.65756269683996,71.34243730316004
PA,1970,1698980,797877,1528940,5102,57850,4088749,1.4148581876754969,98.58514181232451
RI,1970,228,25620,167131,0,5245,198224,2.6459964484623457,97.35400355153766
SC,1970,140118,164305,300420,76,48824,653743,7.468378246497477,92.53162175350252
SD,1970,5674,36464,103787,0,23594,169519,13.918203859154431,86.08179614084557
TN,1970,403742,261784,389234,0,81286,1136046,7.155168012562871,92.84483198743713
TX,1970,30767,4203877,2610292,0,55637,6900573,0.8062663781688854,99.19373362183111
UT,1970,78777,114377,165826,0,4831,363811,1.3278872821327556,98.67211271786725
VA,1970,275311,140072,745710,0,57816,1218909,4.74325811032653,95.25674188967346
VT,1970,2129,2679,73893,0,9153,87854,10.418421471987616,89.58157852801239
WA,1970,5860,158242,506713,28693,303741,1003249,30.275734139779857,69.72426586022014
WI,1970,381558,344241,510121,1725,44830,1282475,3.495584709253592,96.50441529074641
WV,1970,612375,186535,154461,0,14101,967472,1.4575098814229248,98.54249011857708
WY,1970,63488,112526,102687,0,5001,283702,1.7627651549865704,98.23723484501343
US,1970,12268895,21692710,29500112,239347,2289021,65990085,3.4687347349226783,96.53126526507732
AK,1971,14121,68045,109703,0,6526,198395,3.289397414249351,96.71060258575065
AL,1971,626054,294838,364985,0,87971,1373848,6.403255673116677,93.59674432688333
AR,1971,51,334979,269003,0,40836,644869,6.332448915981385,93.66755108401861
AZ,1971,8876,225898,221223,0,27194,483191,5.62800217719287,94.37199782280713
CA,1971,51015,2265324,2655395,38137,254219,5264090,4.829305729955225,95.17069427004478
CO,1971,105682,281846,287557,0,14323,689408,2.0775796045302637,97.92242039546974
CT,1971,36411,62417,544345,84173,17443,744789,2.3420055881598683,97.65799441184014
DC,1971,15432,27663,121369,0,109,164573,0.06623200646521604,99.93376799353479
DE,1971,36677,26981,154105,0,7673,225436,3.403626749942334,96.59637325005767
FL,1971,117154,350527,1168143,0,48181,1684005,2.8610960181234617,97.13890398187654
GA,1971,219607,353199,596435,0,85674,1254915,6.8270759374140875,93.1729240625859
HI,1971,0,0,210390,0,652,211042,0.30894324352498553,99.69105675647502
IA,1971,124704,347740,358258,0,9672,840374,1.1509161397187442,98.84908386028125
ID,1971,12157,53152,107407,0,36666,209382,17.511533942745796,82.4884660572542
IL,1971,843847,1260009,1491335,47396,39664,3682251,1.0771672001718513,98.92283279982814
IN,1971,942253,570398,769271,0,24112,2306034,1.045604704874256,98.95439529512575
KS,1971,10817,605775,306270,0,3890,926752,0.4197455198370222,99.58025448016298
KY,1971,550397,248514,360989,0,36925,1196825,3.085246381049861,96.91475361895014
LA,1971,0,1938558,922075,0,41912,2902545,1.4439741674978337,98.55602583250217
MA,1971,13054,158329,1251293,15554,56260,1494490,3.7644949113075366,96.23550508869246
MD,1971,273953,164689,587854,0,36736,1063232,3.455125504123277,96.54487449587673
ME,1971,2301,1475,281791,0,38020,323587,11.749544944636218,88.25045505536379
MI,1971,837639,863320,991998,4200,41408,2738565,1.5120327616835825,98.48796723831641
MN,1971,155594,352144,527837,15106,26846,1077527,2.491445689991991,97.50855431000801
MO,1971,294143,432108,584900,0,25438,1336589,1.903202854430195,98.09679714556981
MS,1971,13498,387779,288999,0,32841,723117,4.54158870556217,95.45841129443782
MT,1971,11475,91096,133161,0,39457,275189,14.338145783443379,85.66185421655662
NC,1971,484598,164420,647225,0,86337,1382580,6.244629605520115,93.75537039447988
ND,1971,67672,34618,119462,0,11424,233176,4.899303530380485,95.10069646961952
NE,1971,26322,225463,195489,0,6240,453514,1.3759222427532556,98.62407775724674
NH,1971,25496,7658,149111,0,17008,199273,8.535024815203263,91.46497518479674
NJ,1971,91498,335264,1417667,41455,28804,1914688,1.504370424842063,98.49562957515793
NM,1971,120695,291726,157066,0,4772,574259,0.830983928854402,99.16901607114559
NV,1971,36438,71965,96024,0,6794,211221,3.2165362345600106,96.78346376543999
NY,1971,435654,731597,2745083,70670,146920,4129924,3.557450451872722,96.44254954812727
OH,1971,1490481,1112130,1071726,0,43457,3717794,1.1688920903094684,98.83110790969053
OK,1971,164,631152,369703,0,11551,1012570,1.1407606387706528,98.85923936122934
OR,1971,3376,105437,311295,0,176493,596601,29.583088194622537,70.41691180537747
PA,1971,1619609,828583,1558163,4823,55071,4066249,1.3543440158239202,98.64565598417607
RI,1971,211,26201,173903,0,4842,205157,2.3601436948288383,97.63985630517116
SC,1971,152014,160638,313088,26162,53944,705846,7.642460253369715,92.35753974663028
SD,1971,5817,31959,106581,0,27599,171956,16.050036055735188,83.94996394426481
TN,1971,369984,270841,402895,0,86531,1130251,7.655910058916117,92.34408994108388
TX,1971,24048,4482576,2672581,0,54253,7233458,0.7500285478950731,99.24997145210493
UT,1971,78743,113876,179959,0,5661,378239,1.4966727386652354,98.50332726133476
VA,1971,230247,147758,811980,0,58426,1248411,4.6800292531866505,95.31997074681335
VT,1971,1942,3066,73664,0,9348,88020,10.620313565098842,89.37968643490116
WA,1971,6396,165279,520422,27667,311429,1031193,30.200845040647096,69.7991549593529
WI,1971,337268,354746,513461,37596,46037,1289108,3.5712290979499004,96.4287709020501
WV,1971,618797,183553,160762,0,14180,977292,1.4509481301392009,98.5490518698608
WY,1971,58819,117938,108054,0,6060,290871,2.0833977948987696,97.91660220510123
US,1971,11603202,22365248,30541454,412939,2353833,67276676,3.4987355796234643,96.50126442037653
AK,1972,12753,75032,117919,0,6261,211965,2.9537895407260635,97.04621045927394
AL,1972,669734,287100,405130,0,93651,1455615,6.433775414515514,93.56622458548449
AR,1972,50,317640,311260,0,42466,671416,6.324841826825693,93.67515817317431
AZ,1972,7523,241355,261095,0,27928,537901,5.19203347827946,94.80796652172054
CA,1972,47452,2303562,2734460,34266,240952,5360692,4.4947928364472345,95.50520716355277
CO,1972,119005,301651,311194,0,14274,746124,1.9130868327516606,98.08691316724834
CT,1972,4249,65032,605010,83932,18963,777186,2.4399564582995574,97.56004354170044
DC,1972,12557,28976,116424,0,109,158066,0.06895853630761833,99.93104146369238
DE,1972,23493,24569,174116,0,8190,230368,3.555181275177108,96.4448187248229
FL,1972,123613,311235,1328377,713,52730,1816668,2.9025666770152827,97.09743332298471
GA,1972,261592,341408,653498,0,91157,1347655,6.764119897154687,93.23588010284531
HI,1972,0,0,216566,0,859,217425,0.3950787627917673,99.60492123720823
IA,1972,144863,347617,374107,0,10315,876902,1.176300202303108,98.82369979769689
ID,1972,10531,60084,114019,0,38130,222764,17.1167693164066,82.8832306835934
IL,1972,852205,1237471,1642384,141019,40444,3913523,1.0334422462829527,98.96655775371704
IN,1972,1050876,580410,823822,0,28142,2483250,1.1332729286217658,98.86672707137824
KS,1972,12416,626853,333077,0,5670,978016,0.5797451166443085,99.4202548833557
KY,1972,583808,259546,387962,0,40301,1271617,3.1692718798191595,96.83072812018084
LA,1972,0,1996015,1040684,0,44819,3081518,1.45444550380689,98.5455544961931
MA,1972,7677,162204,1307345,16179,53316,1546721,3.4470340804838107,96.55296591951618
MD,1972,226421,180283,650889,0,40217,1097810,3.6633843743452874,96.33661562565472
ME,1972,1402,1554,304132,586,41382,349056,11.855404290429043,88.14459570957095
MI,1972,843677,877742,1074861,22935,43712,2862927,1.5268290110086635,98.47317098899134
MN,1972,161572,352111,583054,38405,28439,1163581,2.444092847855027,97.55590715214497
MO,1972,334355,428192,612120,0,25090,1399757,1.7924539759401097,98.2075460240599
MS,1972,13952,387436,330721,0,32432,764541,4.242022337585558,95.75797766241445
MT,1972,13182,87020,146327,0,38549,285078,13.52226408211086,86.47773591788913
NC,1972,492784,167831,708734,0,90905,1460254,6.225286833660445,93.77471316633955
ND,1972,72820,37604,120172,0,10945,241541,4.531321804579761,95.46867819542024
NE,1972,33509,226358,211472,0,7264,478603,1.5177506200337232,98.48224937996628
NH,1972,30649,8015,153180,0,17285,209129,8.26523342052035,91.73476657947965
NJ,1972,31985,329642,1551304,47008,31067,1991006,1.560366970265283,98.43963302973472
NM,1972,123807,311897,173727,0,4605,614036,0.7499560286367575,99.25004397136324
NV,1972,84363,75223,103141,0,6385,269112,2.3726180920954842,97.62738190790452
NY,1972,355384,707277,2847192,69775,154346,4133974,3.733598711554548,96.26640128844545
OH,1972,1561035,1174203,1151713,0,44878,3931829,1.1414026398401356,98.85859736015986
OK,1972,165,649909,395038,0,16641,1061753,1.5673136784167316,98.43268632158326
OR,1972,2240,115326,340285,0,181788,639639,28.42040588519462,71.57959411480539
PA,1972,1662309,856316,1650519,3112,59430,4231686,1.4044047691629293,98.59559523083708
RI,1972,157,22966,173492,0,4893,201508,2.4281914365682753,97.57180856343173
SC,1972,174934,148156,332011,52110,53756,760967,7.064169668329901,92.9358303316701
SD,1972,5309,34214,111604,0,26557,177684,14.946196618716373,85.05380338128363
TN,1972,444326,283375,444471,0,95548,1267720,7.536995551068059,92.46300444893194
TX,1972,50140,4531777,2995419,0,61777,7639113,0.8086933653161041,99.1913066346839
UT,1972,77580,116399,186443,0,6715,387137,1.7345280869562971,98.2654719130437
VA,1972,198893,159705,860821,4836,60681,1284936,4.722492015166514,95.27750798483349
VT,1972,1355,3817,77415,1828,9394,93809,10.013964544979693,89.98603545502031
WA,1972,36581,179823,555922,31500,325886,1129712,28.84682113671449,71.1531788632855
WI,1972,333641,326921,532257,35547,48836,1277202,3.8236708054011816,96.17632919459882
WV,1972,716520,204916,170824,0,16087,1108347,1.4514407491516645,98.54855925084834
WY,1972,80086,128728,111447,0,5324,325585,1.6352104673126833,98.36478953268731
US,1972,12109530,22682497,32919160,583752,2449491,70744430,3.4624506833965585,96.53754931660345
AK,1973,13286,63703,112132,0,5847,194968,2.9989536744491403,97.00104632555086
AL,1973,688650,279958,450532,3425,99356,1521921,6.528328342929758,93.47167165707025
AR,1973,2262,327475,352744,0,52058,734539,7.087166236237967,92.91283376376204
AZ,1973,9927,226325,325852,0,29132,591236,4.9273048325880024,95.072695167412
CA,1973,66956,2154045,3048428,28689,269058,5567176,4.8329350464221,95.1670649535779
CO,1973,140487,311694,327648,0,14682,794511,1.8479291035618135,98.15207089643819
CT,1973,2625,63548,627116,46911,18751,758951,2.470646985114981,97.52935301488502
DC,1973,14060,28177,122451,0,108,164796,0.06553557125172942,99.93446442874827
DE,1973,21047,23408,194427,0,8483,247365,3.429345299456269,96.57065470054373
FL,1973,152578,324892,1431818,51038,54618,2014944,2.7106460526942686,97.28935394730573
GA,1973,271501,358532,719582,0,96078,1445693,6.645809310828786,93.35419068917122
HI,1973,0,0,222784,0,866,223650,0.3872121618600492,99.61278783813995
IA,1973,148656,369016,395831,0,10368,923871,1.1222345976873396,98.87776540231266
ID,1973,10636,59296,117922,0,39456,227310,17.35779332189521,82.64220667810478
IL,1973,884606,1176722,1707354,218614,42962,4030258,1.0659863462835382,98.93401365371646
IN,1973,1097874,541215,862088,0,28755,2529932,1.1365918135349093,98.8634081864651
KS,1973,24625,597207,352878,0,6009,980719,0.6127137334955273,99.38728626650447
KY,1973,573386,250136,417414,0,40955,1281891,3.1948894250759228,96.80511057492407
LA,1973,0,2072164,1192015,0,45748,3309927,1.3821452859836485,98.61785471401635
MA,1973,5151,157258,1309889,55829,52593,1580720,3.327154714307404,96.6728452856926
MD,1973,256761,177629,695256,0,39956,1169602,3.416204828651114,96.58379517134888
ME,1973,1418,1657,294332,36540,43051,376998,11.419423975724008,88.58057602427598
MI,1973,791284,929555,1122745,32490,39873,2915947,1.3674116847802789,98.63258831521972
MN,1973,180736,360450,602583,35654,29079,1208502,2.4062020584161217,97.59379794158387
MO,1973,383451,424673,632136,0,29800,1470060,2.027128144429479,97.97287185557052
MS,1973,29485,321528,370581,0,32195,753789,4.271089124410147,95.72891087558985
MT,1973,15243,93117,156521,0,32173,297054,10.830690716166083,89.16930928383391
NC,1973,531706,165215,727331,0,93161,1517413,6.1394623612688175,93.86053763873119
ND,1973,71095,33206,120862,0,8514,233677,3.643490801405359,96.35650919859464
NE,1973,36867,230780,214162,6536,7346,495691,1.4819716315204432,98.51802836847956
NH,1973,28325,8120,150480,0,19416,206341,9.409666522891719,90.59033347710829
NJ,1973,66132,309709,1578425,39087,32611,2025964,1.6096534785415733,98.39034652145843
NM,1973,134490,274018,191733,0,4443,604684,0.7347639428197207,99.26523605718027
NV,1973,90083,77967,110673,0,6711,285434,2.3511564845113058,97.6488435154887
NY,1973,369320,703023,2926764,78793,159810,4237710,3.7711405452473152,96.22885945475268
OH,1973,1622805,1131760,1208961,0,46549,4010075,1.160801231897159,98.83919876810285
OK,1973,4085,625808,414787,0,24516,1069196,2.292937871073218,97.70706212892678
OR,1973,2144,114331,344095,0,154643,615213,25.136497440723783,74.86350255927621
PA,1973,1798616,811496,1655536,3941,61297,4330886,1.4153454974340123,98.58465450256598
RI,1973,149,20888,165859,0,5076,191972,2.644135603108787,97.3558643968912
SC,1973,167908,157128,361835,67229,56619,810719,6.983800799043812,93.0161992009562
SD,1973,6341,31283,110634,0,17787,166045,10.712156343159986,89.28784365684001
TN,1973,532943,300079,485933,0,97984,1416939,6.915188303801363,93.08481169619864
TX,1973,125909,4746155,3295589,0,66240,8233893,0.8044797278759876,99.19552027212401
UT,1973,98848,116335,190457,0,6935,412575,1.6809065018481488,98.31909349815186
VA,1973,195912,156669,884314,74765,60018,1371678,4.37551670289966,95.62448329710034
VT,1973,1473,4212,78922,17422,9758,111787,8.72910087935091,91.27089912064909
WA,1973,64974,207952,572821,48321,301720,1195788,25.23189729283117,74.76810270716884
WI,1973,310735,373480,550614,64894,50768,1350491,3.759225348410319,96.24077465158967
WV,1973,810162,191905,178310,0,16026,1196403,1.3395151968024153,98.66048480319759
WY,1973,102406,110445,121873,0,5587,340311,1.6417335907449362,98.35826640925507
US,1973,12960121,22595346,34806025,910177,2475544,73747213,3.3567966832861873,96.64320331671381
AK,1974,12485,63188,117486,0,6035,199194,3.0297097302127574,96.97029026978724
AL,1974,653405,282454,476203,70195,93841,1576098,5.9540079360547375,94.04599206394526
AR,1974,2665,290102,354177,4024,51312,702280,7.306487440906761,92.69351255909324
AZ,1974,48359,204955,325753,0,30033,609100,4.930717451978329,95.06928254802168
CA,1974,60670,1937140,2872447,41277,301484,5213018,5.783290984224493,94.2167090157755
CO,1974,138302,302725,322973,0,14261,778261,1.8324186873041306,98.16758131269587
CT,1974,6522,67139,574032,88951,19499,756143,2.578745025742485,97.42125497425751
DC,1974,12288,27559,98379,0,125,138351,0.09034990712029548,99.9096500928797
DE,1974,21254,20772,189686,0,8466,240178,3.5248857097652575,96.47511429023474
FL,1974,146604,302002,1347129,87919,50662,1934316,2.619117041889743,97.38088295811026
GA,1974,283947,339589,694383,487,95895,1414301,6.7803812625459505,93.21961873745406
HI,1974,0,0,210553,0,904,211457,0.4275100847926529,99.57248991520734
IA,1974,128173,371639,377015,14842,10712,902381,1.1870817315524151,98.81291826844759
ID,1974,11362,55285,120239,0,43380,230266,18.83908175761945,81.16091824238055
IL,1974,874930,1175830,1643496,218667,43077,3956000,1.0889029322548027,98.9110970677452
IN,1974,1038072,530276,851571,0,28888,2448807,1.1796764710326293,98.82032352896736
KS,1974,39107,578795,354364,0,5869,978135,0.6000194247215364,99.39998057527846
KY,1974,593822,231423,408739,0,42781,1276765,3.3507340818396494,96.64926591816035
LA,1974,0,2068614,1258807,0,44928,3372349,1.3322464549191082,98.66775354508088
MA,1974,26447,156666,1161502,32196,53953,1430764,3.770922388318409,96.22907761168159
MD,1974,217510,175541,671671,0,38538,1103260,3.4931022605732105,96.50689773942679
ME,1974,1957,1635,258683,39893,43797,345965,12.659373057968292,87.3406269420317
MI,1974,709962,942595,1082014,4641,42275,2781487,1.5198704865419108,98.4801295134581
MN,1974,188665,351995,575569,48695,29445,1194369,2.465318507094541,97.53468149290546
MO,1974,382005,411933,610794,0,31990,1436722,2.22659637703049,97.77340362296951
MS,1974,34581,283104,378835,0,31279,727799,4.297752538819097,95.7022474611809
MT,1974,14717,81667,158426,0,38210,293020,13.040065524537575,86.95993447546243
NC,1974,522825,143722,685130,0,91169,1442846,6.318692362178639,93.68130763782136
ND,1974,76484,35530,117592,0,9734,239340,4.067017631820841,95.93298236817915
NE,1974,32763,223253,210070,44596,7067,517749,1.3649471075752924,98.63505289242471
NH,1974,25275,8391,139001,0,18395,191062,9.627764809328909,90.37223519067109
NJ,1974,82477,282201,1414664,41000,35079,1855421,1.8906221283471514,98.10937787165285
NM,1974,140947,273397,193141,0,4403,611888,0.7195761315796355,99.28042386842037
NV,1974,100463,67689,109083,0,6512,283747,2.2950022379091233,97.70499776209088
NY,1974,374196,641925,2662440,103490,160434,3942485,4.069362343800927,95.93063765619907
OH,1974,1642125,1114904,1182948,0,48339,3988316,1.212015296681607,98.78798470331839
OK,1974,4187,681130,408315,0,23592,1117224,2.111662477712616,97.88833752228739
OR,1974,3251,102365,318409,0,179758,603783,29.771954493584616,70.22804550641538
PA,1974,1661359,732721,1602646,78108,62288,4137122,1.5055877008219725,98.49441229917802
RI,1974,954,24090,147937,0,4991,177972,2.804373721709033,97.19562627829097
SC,1974,155268,135291,353785,123406,55603,823353,6.753239497518075,93.24676050248192
SD,1974,7356,32044,102368,0,20599,162367,12.686691261155284,87.31330873884471
TN,1974,470336,265374,470394,0,97696,1303800,7.493173799662525,92.50682620033747
TX,1974,133141,4584002,3312660,0,65222,8095025,0.8057047384041433,99.19429526159585
UT,1974,107648,115206,199781,0,5823,428458,1.3590596978000178,98.64094030219998
VA,1974,176954,146811,853442,66437,58458,1302102,4.48951003838409,95.51048996161592
VT,1974,1469,4785,69940,27708,9165,113067,8.105813367295497,91.8941866327045
WA,1974,54167,191311,539132,43409,346630,1174649,29.509240632733693,70.4907593672663
WI,1974,278640,386865,527154,92144,51418,1336221,3.8480161590036377,96.15198384099637
WV,1974,841804,186565,181101,0,15711,1225181,1.282341139798936,98.71765886020107
WY,1974,109107,95363,124555,0,6276,335301,1.8717510535310065,98.128248946469
US,1974,12651009,21729561,33420613,1272083,2586000,71659266,3.6087447504695347,96.39125524953046
AK,1975,15271,85175,123119,0,6112,229677,2.6611284543075713,97.33887154569243
AL,1975,640063,271747,487794,29978,99284,1528866,6.493963499744255,93.50603650025575
AR,1975,862,257445,341236,53676,47582,700801,6.7896592613309625,93.21034073866903
AZ,1975,92449,164346,306751,0,30164,593710,5.080594903235586,94.91940509676441
CA,1975,56405,1937322,2976517,66855,275396,5312495,5.183929584874903,94.8160704151251
CO,1975,159333,280996,326510,0,14190,781029,1.8168339459866407,98.18316605401336
CT,1975,1272,64331,533254,89590,18786,707233,2.65626745358319,97.34373254641682
DC,1975,10142,26210,75960,0,125,112437,0.1111733681973016,99.8888266318027
DE,1975,22938,18975,174335,0,7901,224149,3.524887463249892,96.4751125367501
FL,1975,133463,292139,1378200,92177,48368,1944347,2.4876218082471904,97.51237819175282
GA,1975,311988,335376,655514,34063,93112,1430053,6.511087351307959,93.48891264869204
HI,1975,0,0,212880,0,874,213754,0.408881237310179,99.59111876268982
IA,1975,131562,348564,373735,25235,10885,889981,1.2230598181309489,98.77694018186905
ID,1975,13416,63776,125511,0,46157,248860,18.547376034718315,81.45262396528169
IL,1975,845574,1123588,1621647,245760,42042,3878611,1.0839447420739021,98.9160552579261
IN,1975,1061168,472567,814685,0,28234,2376654,1.1879726708220886,98.81202732917791
KS,1975,62280,490748,384086,0,5779,942893,0.6129009336160095,99.387099066384
KY,1975,558334,209199,415496,0,42637,1225666,3.4786801624586143,96.52131983754138
LA,1975,0,1854766,1205113,0,42358,3102237,1.3654018052134638,98.63459819478653
MA,1975,24484,154583,1124579,41636,50406,1395688,3.6115521520569067,96.3884478479431
MD,1975,197160,141854,593652,48307,39670,1020643,3.8867654997878787,96.11323450021212
ME,1975,1311,1976,222178,49586,41793,316844,13.190402848089281,86.80959715191072
MI,1975,750983,894795,1076579,79031,39694,2841082,1.397143764241933,98.60285623575807
MN,1975,191490,331518,556785,107372,30537,1217702,2.5077564133096604,97.49224358669034
MO,1975,430226,371837,613301,0,31465,1446829,2.1747559663235947,97.82524403367641
MS,1975,33355,235345,377776,0,31152,677628,4.59721262993855,95.40278737006145
MT,1975,18630,81190,154673,0,40908,295401,13.84829435242264,86.15170564757736
NC,1975,476522,116889,636312,15477,90483,1335683,6.774287012711849,93.22571298728815
ND,1975,67943,36862,116903,0,11868,233576,5.08100147275405,94.91899852724595
NE,1975,32886,217521,208267,65153,6914,530741,1.302706970066379,98.69729302993362
NH,1975,26187,7707,137438,0,17107,188439,9.078269360376568,90.92173063962343
NJ,1975,60498,251669,1269139,34645,32854,1648805,1.9925946367217469,98.00740536327825
NM,1975,132535,255637,199475,0,5559,593206,0.9371112227455555,99.06288877725444
NV,1975,101298,65355,115914,0,7009,289576,2.420435395198497,97.5795646048015
NY,1975,312508,585536,2575898,144387,156809,3775138,4.1537289497761405,95.84627105022386
OH,1975,1619050,978885,1200334,0,46247,3844516,1.2029342575242241,98.79706574247578
OK,1975,537,678851,421722,0,22046,1123156,1.9628617930189574,98.03713820698104
OR,1975,2673,114184,306615,23,175662,599157,29.31819205984408,70.68180794015592
PA,1975,1646695,670085,1469329,174766,62841,4023716,1.5617652935743973,98.4382347064256
RI,1975,147,23453,136846,0,4026,164472,2.447833065810594,97.5521669341894
SC,1975,140171,125900,337376,214291,56938,874676,6.5096104157425145,93.49038958425749
SD,1975,24282,32534,103528,0,28521,188865,15.101262806766739,84.89873719323326
TN,1975,471919,224065,492805,0,94729,1283518,7.380418506012382,92.61958149398762
TX,1975,196172,4046930,3220686,0,62394,7526182,0.8290259257615614,99.17097407423844
UT,1975,115740,117952,203889,0,6560,444141,1.4770084275038782,98.52299157249612
VA,1975,169188,123625,824369,98782,57695,1273659,4.529862388598518,95.47013761140148
VT,1975,744,4005,68977,39220,9800,122746,7.983966890978118,92.01603310902188
WA,1975,76241,171236,548878,36432,349910,1182697,29.585768797925418,70.41423120207457
WI,1975,272045,372097,524308,113356,51823,1333629,3.8858633098110493,96.11413669018896
WV,1975,817441,164297,198211,0,15366,1195315,1.2855188799605124,98.7144811200395
WY,1975,128034,81434,129694,0,5391,344553,1.5646359195827637,98.43536408041723
US,1975,12655613,19977076,32698781,1899798,2544166,69775434,3.646220244219477,96.35377975578052
AK,1976,13706,90571,141170,0,6532,251979,2.5922795153564384,97.40772048464356
AL,1976,632096,232758,532874,46557,95154,1539439,6.18108284901188,93.81891715098811
AR,1976,3578,248194,379963,42614,48224,722573,6.673927755396341,93.32607224460367
AZ,1976,139960,180181,307360,0,31674,659175,4.805097280691774,95.19490271930823
CA,1976,66630,1849711,3244758,53107,236233,5450439,4.334201336809751,95.66579866319024
CO,1976,185147,276287,344788,0,14670,820892,1.7870803954722423,98.21291960452776
CT,1976,1152,66382,555426,136215,21194,780369,2.7158946600902905,97.28410533990971
DC,1976,5844,29040,76714,0,142,111740,0.12708072310721316,99.87291927689279
DE,1976,20186,19662,185462,0,9607,234917,4.089529493395539,95.91047050660445
FL,1976,141836,300867,1477405,95538,54703,2070349,2.6422115305197336,97.35778846948027
GA,1976,347552,268375,727308,45666,104309,1493210,6.985554610537031,93.01444538946296
HI,1976,0,0,218380,0,1017,219397,0.4635432572004175,99.53645674279959
IA,1976,169471,313917,410376,27384,10696,931844,1.1478316112997455,98.85216838870025
ID,1976,15162,49843,130343,0,49181,244529,20.112542888573543,79.88745711142646
IL,1976,862231,1204616,1671086,292243,46568,4076744,1.142284136556036,98.85771586344396
IN,1976,1062942,420969,877430,0,32684,2394025,1.3652321926462756,98.63476780735373
KS,1976,73379,505408,402421,0,6490,987698,0.6570834404848446,99.34291655951516
KY,1976,617452,248673,446144,0,46122,1358391,3.395340516832046,96.60465948316795
LA,1976,0,2121366,1378762,0,45170,3545298,1.2740818966416927,98.72591810335831
MA,1976,3953,157185,1215625,40475,57090,1474328,3.8722726557455327,96.12772734425447
MD,1976,245318,149642,607311,70921,41835,1115027,3.7519270833800435,96.24807291661996
ME,1976,1050,2083,258409,65496,48561,375599,12.928948160138871,87.07105183986113
MI,1976,717683,895140,1143534,109371,45173,2910901,1.5518562809247034,98.44814371907529
MN,1976,222441,319516,599225,109482,31541,1282205,2.459903057623391,97.5400969423766
MO,1976,468324,381399,644310,0,34386,1528419,2.2497757486657783,97.75022425133422
MS,1976,42531,203702,420661,0,34819,701713,4.9620001339579005,95.0379998660421
MT,1976,42179,75412,166959,0,49489,334039,14.815335933828086,85.18466406617192
NC,1976,544481,102996,706387,27744,97627,1479235,6.599830317697999,93.400169682302
ND,1976,91487,41177,116538,0,11636,260838,4.461006448446929,95.53899355155308
NE,1976,53712,197442,229551,64335,7493,552533,1.3561180961137163,98.64388190388628
NH,1976,20331,7919,159996,0,20502,208748,9.821411462624791,90.1785885373752
NJ,1976,70596,332467,1348518,42587,36800,1830968,2.0098658196101735,97.99013418038983
NM,1976,137492,294878,202452,0,6251,641073,0.9750839607969763,99.02491603920302
NV,1976,111294,71205,115566,0,6636,304701,2.1778727342542363,97.82212726574576
NY,1976,363821,604276,2746055,172988,167710,4054850,4.136034625201919,95.86396537479808
OH,1976,1653336,1031075,1287362,0,52786,4024559,1.3115971215728233,98.68840287842718
OK,1976,1541,770752,439476,0,18576,1230345,1.5098204162247175,98.49017958377529
OR,1976,5876,95830,312312,23227,188065,625310,30.075482560649917,69.92451743935008
PA,1976,1682817,731356,1623254,181447,71329,4290203,1.6626019794401337,98.33739802055986
RI,1976,146,20966,140424,0,4682,166218,2.8167827792417186,97.18321722075828
SC,1976,171042,152416,386714,197186,59585,966943,6.162203976863165,93.83779602313683
SD,1976,37063,39168,103359,0,25744,205334,12.5376216310986,87.4623783689014
TN,1976,561514,218483,551645,0,94118,1425760,6.60125126248457,93.39874873751543
TX,1976,226342,4074690,3481271,0,68529,7850832,0.8728883766714152,99.12711162332859
UT,1976,101774,138603,207169,0,7111,454657,1.5640361855200733,98.43596381447993
VA,1976,202247,125855,856635,85506,69865,1340108,5.213385786817182,94.78661421318282
VT,1976,579,3700,78973,36013,11741,131006,8.962184938094438,91.03781506190556
WA,1976,81205,154881,558392,26568,393673,1214719,32.40856527312078,67.59143472687921
WI,1976,303970,320512,570026,118450,58073,1371031,4.235717500187815,95.76428249981218
WV,1976,872351,157204,216353,0,17617,1263525,1.3942739557982629,98.60572604420173
WY,1976,179069,82478,139354,0,5285,406186,1.3011280546350688,98.69887194536493
US,1976,13575890,20381227,35141985,2111121,2704698,73914921,3.6592043438698933,96.34079565613011
AK,1977,10259,116859,154922,0,7853,289893,2.708930536439307,97.29106946356069
AL,1977,629412,248715,573518,210228,102034,1763907,5.784545330337711,94.2154546696623
AR,1977,5244,234379,424446,54759,57171,775999,7.3674064012969085,92.6325935987031
AZ,1977,179847,176449,351150,0,29348,736794,3.9832029033895497,96.01679709661045
CA,1977,75109,1864187,3611311,87396,212831,5850834,3.6376181583685336,96.36238184163146
CO,1977,223762,253994,355019,2421,16129,851325,1.8945761019587115,98.1054238980413
CT,1977,1167,64709,550634,141876,21078,779464,2.704165939671364,97.29583406032863
DC,1977,3991,26212,84100,0,158,114461,0.13803828378224897,99.86196171621775
DE,1977,17713,16261,189670,0,10161,233805,4.34592930005774,95.65407069994225
FL,1977,159934,315950,1502009,189076,58246,2225215,2.617544821511629,97.38245517848837
GA,1977,415733,271811,757522,39985,107806,1592857,6.768090293102269,93.23190970689774
HI,1977,0,0,231980,0,752,232732,0.32311843665675544,99.67688156334324
IA,1977,185141,281367,417143,31102,11612,926365,1.2535015895462371,98.74649841045377
ID,1977,12102,48269,134913,0,38568,233852,16.492482424781485,83.50751757521851
IL,1977,860555,1199778,1711734,307424,50404,4129895,1.22046686416967,98.77953313583033
IN,1977,1109953,394286,910868,0,36144,2451251,1.4745124020347162,98.52548759796528
KS,1977,89517,497279,408962,0,6831,1002589,0.6813360210415235,99.31866397895848
KY,1977,613466,221936,478067,0,40872,1354341,3.017851486442484,96.98214851355752
LA,1977,1774,2274100,1605874,0,46692,3928440,1.188563399211901,98.8114366007881
MA,1977,4008,161465,1195175,39571,60390,1460609,4.13457674161942,95.86542325838057
MD,1977,189728,135168,617684,117181,45399,1105160,4.107911976546382,95.89208802345362
ME,1977,603,2047,263043,55386,51373,372452,13.79318677306069,86.2068132269393
MI,1977,692982,745743,1170987,110182,48180,2768074,1.7405604040932432,98.25943959590676
MN,1977,264929,292501,584823,120211,32020,1294484,2.4735724813902684,97.52642751860974
MO,1977,503909,367704,667599,0,34792,1574004,2.2104136965344434,97.78958630346555
MS,1977,38658,202631,477480,0,36230,754999,4.798681852558745,95.20131814744126
MT,1977,57814,71595,163936,0,37918,331263,11.44649417532293,88.55350582467707
NC,1977,548103,73905,754860,60997,109436,1547301,7.072702725584744,92.92729727441525
ND,1977,107264,37650,115140,0,7331,267385,2.741739439385156,97.25826056061484
NE,1977,59344,188426,231193,80249,7563,566775,1.3343919544792908,98.66560804552071
NH,1977,26470,7617,158532,0,21410,214029,10.003317307467679,89.99668269253232
NJ,1977,71011,255522,1365149,74941,39684,1806307,2.1969687323361975,97.8030312676638
NM,1977,153922,242912,212605,0,7131,616570,1.1565596769223283,98.84344032307767
NV,1977,115938,74534,127198,0,7025,324695,2.163568887725404,97.8364311122746
NY,1977,336851,567877,2762674,221730,161823,4050955,3.9946876724130482,96.00531232758695
OH,1977,1669162,867837,1350669,5039,58541,3951248,1.4815825278494288,98.51841747215057
OK,1977,12381,787694,457902,0,20457,1278434,1.6001608217553662,98.39983917824463
OR,1977,5223,75567,338296,69916,156515,645517,24.246456716089583,75.75354328391042
PA,1977,1577975,682372,1716994,191913,75860,4245114,1.786995590695562,98.21300440930443
RI,1977,117,25964,143166,0,5270,174517,3.0197631176332393,96.98023688236677
SC,1977,189564,141633,418568,185645,59462,994872,5.976849283123859,94.02315071687615
SD,1977,35614,36097,104619,0,19955,196285,10.166339761061721,89.83366023893828
TN,1977,553721,208401,582671,0,103215,1448008,7.128068353213518,92.87193164678648
TX,1977,288187,4254885,3885371,0,74355,8502798,0.8744768486796934,99.12552315132031
UT,1977,132845,100999,211890,0,6394,452128,1.4142012881307948,98.5857987118692
VA,1977,187029,120734,900885,102103,68791,1379542,4.986510015642873,95.01348998435712
VT,1977,719,4025,77992,38097,12642,133475,9.471436598613973,90.52856340138602
WA,1977,102385,149077,600518,46468,305612,1204060,25.381791605069516,74.61820839493049
WI,1977,307515,354397,582503,117864,61728,1424007,4.334810151916388,95.66518984808361
WV,1977,847721,150605,235436,0,17697,1251459,1.4141094514482695,98.58589054855173
WY,1977,230740,78354,153243,0,4586,466923,0.982174791132585,99.01782520886742
US,1977,13907111,19972477,37082642,2701762,2613473,76277465,3.426271442030749,96.57372855796925
AK,1978,4689,145025,163486,0,7530,320730,2.3477691516228605,97.65223084837714
AL,1978,577580,244969,577713,249788,93491,1743541,5.362133726709036,94.63786627329097
AR,1978,22833,220898,421092,57113,60263,782199,7.704305426112792,92.2956945738872
AZ,1978,159980,186366,357372,0,31083,734801,4.230124890956871,95.76987510904313
CA,1978,67892,1646333,3654422,83801,297367,5749815,5.171766395962305,94.82823360403769
CO,1978,218619,234600,375010,6664,20056,854949,2.34587092329484,97.65412907670516
CT,1978,807,66038,563328,151674,23894,805741,2.9654690527104863,97.03453094728951
DC,1978,2017,26551,80033,0,193,108794,0.1773994889424049,99.8226005110576
DE,1978,21812,21263,181109,0,10667,234851,4.542028775691822,95.45797122430818
FL,1978,175522,333306,1580785,172977,63773,2326363,2.741317670544107,97.2586823294559
GA,1978,434380,286035,754682,46798,112073,1633968,6.858947054042674,93.14105294595733
HI,1978,0,0,235827,0,561,236388,0.2373216914564191,99.76267830854358
IA,1978,201296,238754,414715,13225,12823,880813,1.455814117184919,98.54418588281509
ID,1978,11424,46570,143602,0,50743,252339,20.109059638026622,79.89094036197338
IL,1978,841562,1196435,1779961,360238,62032,4240228,1.462940200385451,98.53705979961455
IN,1978,1074576,436149,929585,0,43307,2483617,1.7437068597935994,98.2562931402064
KS,1978,136849,507973,423333,0,7507,1075662,0.6978958074190591,99.30210419258094
KY,1978,617183,215021,497715,0,48406,1378325,3.5119438448841893,96.48805615511581
LA,1978,3747,2349710,1676335,0,47825,4077617,1.172866407021552,98.82713359297844
MA,1978,3163,161964,1171738,60943,66192,1464000,4.521311475409836,95.47868852459017
MD,1978,209720,139642,627433,108272,47194,1132261,4.168120247893374,95.83187975210663
ME,1978,719,2166,244392,58582,55242,361101,15.298212965347645,84.70178703465236
MI,1978,671257,793936,1215137,143373,58730,2882433,2.0375148355573227,97.96248516444268
MN,1978,255741,312196,601144,126822,42722,1338625,3.1914837986740126,96.80851620132599
MO,1978,485655,360269,694616,0,42593,1583133,2.690424620041399,97.3095753799586
MS,1978,40994,208038,511668,0,37576,798276,4.707143895093927,95.29285610490608
MT,1978,57597,72686,172332,0,50828,353443,14.380819538086763,85.61918046191323
NC,1978,499873,83695,743733,108501,121076,1556878,7.776845713023114,92.22315428697688
ND,1978,129778,39067,120575,0,10878,300298,3.6224017475973866,96.37759825240262
NE,1978,59813,162693,246421,84522,7845,561294,1.397663256689008,98.60233674331099
NH,1978,20409,8204,158511,0,23145,210269,11.007328707512757,88.99267129248724
NJ,1978,60820,236852,1361982,89372,42867,1791893,2.3922745387140862,97.60772546128591
NM,1978,145738,225451,215103,0,7780,594072,1.3096055696952558,98.69039443030475
NV,1978,91272,66305,149414,0,7403,314394,2.3546887027106114,97.64531129728938
NY,1978,297344,576482,2737616,237431,173677,4022550,4.317584616723223,95.68241538327678
OH,1978,1622430,950973,1369852,26533,69599,4039387,1.7230089615082684,98.27699103849173
OK,1978,43718,788658,482959,0,25164,1340499,1.8772113966515453,98.12278860334845
OR,1978,4672,90025,360125,17104,186895,658821,28.368099984669584,71.63190001533042
PA,1978,1572452,688256,1713648,244304,85255,4303915,1.9808709047460278,98.01912909525397
RI,1978,123,23339,132150,0,6550,162162,4.039170705837373,95.96082929416262
SC,1978,192321,121336,416663,212875,61587,1004782,6.129389260556021,93.87061073944398
SD,1978,38551,35395,110390,0,25337,209673,12.084054694691257,87.91594530530874
TN,1978,564711,189201,610104,0,102006,1466022,6.958012908401102,93.0419870915989
TX,1978,418438,4329773,4145601,0,78861,8972673,0.8789019726897436,99.12109802731025
UT,1978,143943,113322,216782,0,6995,481042,1.4541349819766258,98.54586501802338
VA,1978,170626,136935,878353,154249,77458,1417621,5.463942760441613,94.53605723955839
VT,1978,477,3819,78180,35456,14431,132363,10.902593625106714,89.09740637489328
WA,1978,84724,133338,621666,45301,384391,1269420,30.28083691764743,69.71916308235257
WI,1978,296054,375286,605891,128208,74303,1479742,5.021348316125379,94.97865168387462
WV,1978,785705,156607,224998,0,20827,1188137,1.7529123325003766,98.24708766749963
WY,1978,228079,79758,169839,0,5948,483624,1.22988106462872,98.77011893537129
US,1978,13769684,20067662,37919119,3024126,3014948,77795539,3.875476715959253,96.12452328404075
AK,1979,4182,157236,127623,0,7550,296591,2.5455930894733827,97.45440691052661
AL,1979,670208,291485,491310,240321,108365,1801689,6.01463404616446,93.98536595383554
AR,1979,31728,255010,358872,42139,57348,745097,7.6967159980512605,92.30328400194874
AZ,1979,246230,180580,345796,0,33049,805655,4.102128082119518,95.89787191788048
CA,1979,68565,1900357,3733951,95320,297376,6095569,4.87856014754324,95.12143985245676
CO,1979,238041,260824,340605,2316,21984,863770,2.5451219653379953,97.454878034662
CT,1979,1070,68752,533199,138231,26157,767409,3.4084823086515796,96.59151769134841
DC,1979,2889,30129,57506,0,210,90734,0.23144576454250887,99.76855423545749
DE,1979,23914,25758,191828,0,8729,250229,3.488404621366828,96.51159537863317
FL,1979,202251,357014,1629347,167438,67748,2423798,2.7951174149000866,97.20488258509991
GA,1979,469598,324478,742459,55429,118391,1710355,6.922013266251743,93.07798673374826
HI,1979,0,0,255346,0,634,255980,0.24767559965622316,99.75232440034378
IA,1979,219445,292191,425775,31432,12715,981558,1.2953895745335477,98.70461042546646
ID,1979,11856,56792,135383,0,50115,254146,19.718980428572554,80.28101957142745
IL,1979,845402,1170615,1679342,298772,63724,4057855,1.57038632479475,98.42961367520525
IN,1979,1171644,499345,850765,0,48814,2570568,1.8989577400792355,98.10104225992076
KS,1979,147482,571266,439116,0,7903,1165767,0.6779227753058716,99.32207722469413
KY,1979,609287,220854,502174,0,55181,1387496,3.9770204742932593,96.02297952570675
LA,1979,2518,2051384,1875478,0,44717,3974097,1.1252115889471244,98.87478841105288
MA,1979,4632,157883,990909,66113,71256,1290793,5.520327426628437,94.47967257337156
MD,1979,240709,179631,600818,105240,51121,1177519,4.341416147000601,95.6585838529994
ME,1979,778,2162,223074,48928,57535,332477,17.304956433076573,82.69504356692343
MI,1979,758928,880367,1038344,164699,64810,2907148,2.229332665554007,97.77066733444599
MN,1979,229460,332631,567901,125146,47583,1302721,3.6525856265462826,96.34741437345372
MO,1979,512505,340138,658767,0,48307,1559717,3.097164421494412,96.90283557850559
MS,1979,59765,260547,451900,0,37510,809722,4.632454101531143,95.36754589846886
MT,1979,63407,69114,186730,0,47605,366856,12.976481235144036,87.02351876485596
NC,1979,558638,133751,735741,74080,136690,1638900,8.340350234913661,91.65964976508634
ND,1979,148077,29236,136221,0,9896,323430,3.059703799894877,96.94029620010512
NE,1979,77604,168959,224645,94196,8184,573588,1.4268080922195026,98.5731919077805
NH,1979,29080,8699,137488,0,25139,200406,12.544035607716335,87.45596439228366
NJ,1979,59195,269934,1317117,71918,45068,1763232,2.5559880945899347,97.44401190541006
NM,1979,152939,223092,214617,0,9451,600099,1.5749068070435044,98.4250931929565
NV,1979,99307,85539,138630,0,7890,331366,2.381052974656422,97.61894702534357
NY,1979,315174,633562,2382107,201340,184538,3716721,4.965075398449332,95.03492460155067
OH,1979,1668432,920390,1384084,34412,74626,4081944,1.8281975450912604,98.17180245490874
OK,1979,60391,844294,465726,0,30683,1401094,2.189931582035181,97.81006841796481
OR,1979,4679,97905,363933,48900,179986,695403,25.882258201359498,74.1177417986405
PA,1979,1756262,756079,1621351,204484,98356,4436532,2.2169568482769875,97.783043151723
RI,1979,122,27526,115620,0,7101,150369,4.722382937972587,95.27761706202742
SC,1979,206761,121479,391960,198220,64051,982471,6.519378180119311,93.48062181988068
SD,1979,35473,25611,118250,0,23678,203012,11.663349949756665,88.33665005024334
TN,1979,542302,233860,566792,0,121834,1464788,8.317517620297272,91.68248237970273
TX,1979,587642,4131399,4561292,0,81375,9361708,0.8692324092996705,99.13076759070033
UT,1979,170907,120980,213386,0,8068,513341,1.5716648387718886,98.4283351612281
VA,1979,213734,136958,886409,76758,84470,1398329,6.040781532815239,93.95921846718475
VT,1979,595,4398,71419,37521,15888,129821,12.238389782854854,87.76161021714515
WA,1979,99003,165950,621007,39301,348746,1274007,27.3739469249384,72.62605307506159
WI,1979,321063,372258,564808,113175,76956,1448260,5.313686768950326,94.68631323104967
WV,1979,828830,152059,234025,0,25324,1240238,2.0418661579471036,97.9581338420529
WY,1979,268946,87157,174797,0,6595,537495,1.226988158029377,98.77301184197063
US,1979,15041652,20687615,37075744,2775827,3131030,78711868,3.977837243044467,96.02216275695554
AK,1980,4310,153805,129309,0,4562,291986,1.562403676888618,98.43759632311138
AL,1980,661023,278342,450362,256310,173134,1819171,9.517192171599042,90.48280782840096
AR,1980,36648,273987,299725,85438,58173,753971,7.715548741264584,92.28445125873542
AZ,1980,244994,173970,301281,0,51394,771639,6.6603683846980255,93.33963161530197
CA,1980,66170,1890887,3477280,53665,272059,5760061,4.723196507814761,95.27680349218524
CO,1980,247615,244771,327783,7273,16606,844048,1.9674236536310732,98.03257634636893
CT,1980,364,74033,502250,129094,41962,747703,5.612121390445137,94.38787860955486
DC,1980,3284,27950,47702,0,2849,81785,3.4835238735709484,96.51647612642905
DE,1980,28063,30783,184800,0,2472,246118,1.0043962652061207,98.99560373479387
FL,1980,225457,329567,1650717,182563,88551,2476855,3.5751386334686526,96.42486136653135
GA,1980,521518,325263,692211,92015,113186,1744193,6.489304795971547,93.51069520402845
HI,1980,0,0,249539,0,12205,261744,4.6629531144935505,95.33704688550645
IA,1980,234425,270333,350023,27955,51956,934692,5.558622519503751,94.44137748049624
ID,1980,9610,51646,112680,0,47085,221021,21.303405558747812,78.69659444125219
IL,1980,844481,1076174,1447866,302604,91400,3762525,2.4292197394037247,97.57078026059628
IN,1980,1156965,482288,742766,0,52835,2434854,2.1699453026752322,97.83005469732477
KS,1980,191574,481990,372660,0,9030,1055254,0.8557181493744634,99.14428185062553
KY,1980,641685,204062,481043,0,35315,1362105,2.592678244335055,97.40732175566494
LA,1980,2456,1862179,1859619,0,64707,3788961,1.7077768813139012,98.2922231186861
MA,1980,22845,169897,910027,35255,71392,1209416,5.903014347420573,94.09698565257942
MD,1980,235710,162955,532945,119409,36966,1087985,3.3976571368171435,96.60234286318286
ME,1980,3008,2162,198340,48040,104264,355814,29.30295041791498,70.69704958208503
MI,1980,759026,874651,906659,173339,94669,2808344,3.370990163598192,96.6290098364018
MN,1980,242420,284941,498349,109374,49308,1184392,4.163148687258948,95.83685131274105
MO,1980,531438,322842,560667,0,26988,1441935,1.8716516347824277,98.12834836521758
MS,1980,74997,270909,382612,0,38097,766615,4.96950881472447,95.03049118527552
MT,1980,60228,61453,163682,0,45088,330451,13.644382979624815,86.35561702037518
NC,1980,624696,155149,658887,62997,97637,1599366,6.104731499856818,93.89526850014319
ND,1980,163322,23830,126840,0,11023,325015,3.3915357752719104,96.6084642247281
NE,1980,93942,159483,189490,63082,10460,516457,2.0253380242692036,97.9746619757308
NH,1980,29275,8874,133609,0,25219,196977,12.803017611193185,87.19698238880682
NJ,1980,68692,341149,1249507,83192,50354,1792894,2.808531904284358,97.19146809571563
NM,1980,202870,231330,201366,0,5566,641132,0.8681519562274227,99.13184804377258
NV,1980,93216,62016,147127,0,10855,313214,3.4656816106559734,96.53431838934402
NY,1980,313708,752573,2135731,210259,219986,3632257,6.056454705710527,93.94354529428948
OH,1980,1528107,841059,1301153,23115,107332,3800766,2.8239570654967974,97.1760429345032
OK,1980,106346,738931,442550,0,15685,1303512,1.203287733446259,98.79671226655374
OR,1980,12102,82324,334332,58844,190297,677899,28.07158588521299,71.92841411478702
PA,1980,1636051,789585,1436379,131893,131704,4125612,3.1923506136786495,96.80764938632134
RI,1980,165,27948,102801,0,7279,138193,5.267271135296289,94.73272886470372
SC,1980,245769,146846,351306,189846,50083,983850,5.090511765004828,94.90948823499517
SD,1980,36564,24020,101874,0,23189,185647,12.490910168222486,87.50908983177752
TN,1980,576894,233323,501001,5660,99231,1416109,7.007299579340291,92.99270042065972
TX,1980,734145,4226105,4451936,0,58988,9471174,0.6228161366267794,99.37718386337322
UT,1980,168254,124990,200325,0,7295,500864,1.4564831970355225,98.54351680296448
VA,1980,231849,160886,737949,125071,79350,1335105,5.943352770006854,94.05664722999315
VT,1980,537,3951,61631,32497,17207,115823,14.856289338041668,85.14371066195834
WA,1980,90956,135451,594767,22269,371848,1215291,30.597445385508493,69.4025546144915
WI,1980,327310,354670,474923,108111,172558,1437572,12.003433567153506,87.99656643284649
WV,1980,857779,147624,217628,0,15651,1238682,1.2635204192843683,98.73647958071564
WY,1980,268122,72982,173524,0,6519,521147,1.2508946611992393,98.74910533880076
US,1980,15460982,20226934,34159533,2739169,3441570,76028188,4.526702648759694,95.4732973512403
AK,1981,12521,122214,135710,0,5060,275505,1.8366272844412987,98.16337271555871
AL,1981,629957,281022,444499,260780,170843,1787101,9.55978425393976,90.44021574606023
AR,1981,101935,265043,289016,100093,59550,815637,7.301042007657818,92.69895799234219
AZ,1981,319438,192208,284450,0,44681,840777,5.314250984505999,94.685749015494
CA,1981,78401,1947370,3210880,35367,254048,5526066,4.5972668440804,95.4027331559196
CO,1981,278732,201432,301714,8261,18903,809042,2.336467080819043,97.66353291918095
CT,1981,904,77126,436491,139788,41128,695437,5.913979267712244,94.08602073228775
DC,1981,2406,29428,40354,0,2312,74500,3.1033557046979867,96.89664429530201
DE,1981,50618,31576,138619,0,2006,222819,0.9002822919050889,99.09971770809491
FL,1981,236471,357470,1624227,159362,82431,2459961,3.3509067826685057,96.6490932173315
GA,1981,552108,325103,652903,79799,106352,1716265,6.196712046216639,93.80328795378337
HI,1981,0,0,223133,0,13019,236152,5.51297469426471,94.48702530573529
IA,1981,252126,253927,328458,24309,57265,916085,6.251057489206787,93.74894251079321
ID,1981,9801,48107,98602,0,48758,205268,23.75333710076583,76.24666289923417
IL,1981,796603,1053097,1264078,325199,99380,3538357,2.808648194628185,97.19135180537181
IN,1981,1150611,487854,683466,0,55600,2377531,2.3385604646164446,97.66143953538355
KS,1981,212932,422564,335099,0,8429,979024,0.8609594861821569,99.13904051381785
KY,1981,663926,202235,432910,0,36864,1335935,2.7594156901346247,97.24058430986537
LA,1981,23727,1847639,1843551,0,68263,3783180,1.8043814991620806,98.19561850083792
MA,1981,26644,165351,849197,47766,70179,1159137,6.0544180713755145,93.94558192862449
MD,1981,210368,177238,496635,127095,35409,1046745,3.382772308441884,96.61722769155811
ME,1981,3141,2288,194633,57488,109699,367249,29.87046935457959,70.12953064542042
MI,1981,757492,811399,817824,188239,100139,2675093,3.7433838748783685,96.25661612512162
MN,1981,244190,264845,450175,112360,50015,1121585,4.459314273996175,95.54068572600383
MO,1981,536042,287706,535243,0,25816,1384807,1.8642309000459991,98.135769099954
MS,1981,82948,249062,352407,0,41070,725487,5.661024939109867,94.33897506089014
MT,1981,62539,53029,143907,0,51267,310742,16.498252569655858,83.50174743034414
NC,1981,655284,154283,611184,68894,87649,1577294,5.5569221717701325,94.44307782822986
ND,1981,172400,35457,126589,0,10128,344574,2.939281547650142,97.06071845234986
NE,1981,98584,133481,176315,66048,9686,484114,2.000768414051236,97.99923158594876
NH,1981,24226,9709,122799,0,26492,183226,14.458646698612643,85.54135330138736
NJ,1981,75464,391491,1159200,128776,56051,1810982,3.0950611325788993,96.9049388674211
NM,1981,196933,205433,213772,0,7112,623250,1.141115122342559,98.85888487765745
NV,1981,112197,78744,130637,0,9627,331205,2.906659017828837,97.09334098217116
NY,1981,308653,770856,1909639,192412,231595,3413155,6.785364274403008,93.21463572559699
OH,1981,1534900,818902,1199908,48607,112984,3715301,3.041045664940741,96.95895433505926
OK,1981,157728,694455,435481,0,15983,1303647,1.2260220749942277,98.77397792500577
OR,1981,25826,78887,333667,70856,202366,711602,28.43808758266559,71.56191241733441
PA,1981,1495944,791190,1297668,157462,143018,3885282,3.6810198075712393,96.31898019242875
RI,1981,192,28873,92461,0,6648,128174,5.186699330597469,94.81330066940254
SC,1981,266523,145000,332406,191120,43459,978508,4.441353570946788,95.55864642905321
SD,1981,36204,22076,92817,0,21281,172378,12.345542934713247,87.65445706528675
TN,1981,565947,227063,492503,51886,95001,1432400,6.632295448198827,93.36770455180117
TX,1981,858514,4052341,4267534,0,62452,9240841,0.675825934024836,99.32417406597516
UT,1981,175686,109703,168355,0,8001,461745,1.73277458337394,98.26722541662606
VA,1981,264301,154925,648378,196535,76702,1340841,5.7204396345278825,94.27956036547212
VT,1981,1030,4352,58643,39362,17764,121151,14.66269366327971,85.33730633672029
WA,1981,90872,131176,600871,22523,414784,1260226,32.91346155372132,67.08653844627868
WI,1981,327327,327529,439877,107201,181562,1383496,13.123420667641973,86.87657933235802
WV,1981,877497,154468,205098,0,14349,1251412,1.1466247726568068,98.8533752273432
WY,1981,318915,72895,160096,0,6204,558110,1.111608822633531,98.88839117736647
US,1981,15937724,19749623,31884079,3007589,3519386,74098401,4.749611263541301,95.2503887364587
AK,1982,13182,237881,149249,0,4791,405103,1.1826621871474663,98.81733781285253
AL,1982,511059,253391,440359,306734,189979,1701522,11.165239121210305,88.8347608787897
AR,1982,125193,227389,281576,82852,62820,779830,8.05560186194427,91.94439813805573
AZ,1982,336245,142323,278455,0,45570,802593,5.677846679450232,94.32215332054977
CA,1982,69415,1765171,2874156,41357,315009,5065108,6.219196115857747,93.78080388414226
CO,1982,276433,216115,308533,6299,20424,827804,2.4672507018569614,97.53274929814305
CT,1982,763,79253,435008,150866,38869,704759,5.515218677590496,94.4847813224095
DC,1982,3064,29731,45763,0,3654,82212,4.444606626769815,95.55539337323019
DE,1982,47947,28694,121917,0,3170,201728,1.5714229060913705,98.42857709390863
FL,1982,240178,339099,1416264,213919,103685,2313145,4.482425442417142,95.51757455758286
GA,1982,535439,303335,642879,73144,118157,1672954,7.062776382375128,92.93722361762487
HI,1982,1149,0,203563,0,12747,217459,5.861794637149991,94.13820536285
IA,1982,243876,238917,339038,25126,60441,907398,6.660913953965074,93.33908604603492
ID,1982,10358,42849,96011,0,55635,204853,27.158499021249384,72.84150097875062
IL,1982,778512,996628,1167292,305891,107560,3355883,3.2051176992761667,96.79488230072383
IN,1982,1007163,471776,638602,0,56082,2173623,2.580116239108622,97.41988376089138
KS,1982,212511,400519,337084,0,10346,960460,1.0771921787476835,98.92280782125232
KY,1982,626978,191042,429833,0,45977,1293830,3.5535580408554446,96.44644195914455
LA,1982,64251,1629186,1680330,0,69667,3443434,2.023183833347757,97.97681616665224
MA,1982,89641,181781,798283,46212,64869,1180786,5.493713509475891,94.5062864905241
MD,1982,217256,159832,472074,114555,42156,1005873,4.190986337241381,95.80901366275862
ME,1982,6935,2686,230398,50097,106183,396299,26.793658323639473,73.20634167636052
MI,1982,711387,762073,745764,166124,100602,2485950,4.046823146080975,95.95317685391902
MN,1982,212528,263011,467279,112911,51883,1107612,4.684221550506856,95.31577844949314
MO,1982,523817,282312,543957,0,32293,1382379,2.336045324762601,97.66395467523739
MS,1982,100518,276666,314441,0,44643,736268,6.063417125285901,93.9365828747141
MT,1982,48650,52782,130099,0,49784,281315,17.69688783036809,82.3031121696319
NC,1982,622104,146759,600316,101057,105279,1575515,6.682195980361977,93.31780401963802
ND,1982,198916,29003,122775,0,11878,362572,3.276038966053639,96.72396103394637
NE,1982,96746,135550,184673,96917,11203,525089,2.133543075554811,97.86645692444519
NH,1982,27624,9686,114853,0,24959,177122,14.091417215252763,85.90858278474724
NJ,1982,78375,377216,1191430,155455,50775,1853251,2.7397799866289025,97.2602200133711
NM,1982,225549,213347,187749,0,7482,634127,1.1798898327937464,98.82011016720625
NV,1982,146479,49889,128355,0,8714,333437,2.613387236569427,97.38661276343058
NY,1982,288982,790695,1775955,159870,217430,3232932,6.72547396604692,93.27452603395308
OH,1982,1392042,770419,1124585,35722,114273,3437041,3.32474939926524,96.67525060073476
OK,1982,203812,692328,443116,0,22720,1361976,1.6681644904168649,98.33183550958313
OR,1982,11803,73916,341618,53062,242666,723065,33.5607448846231,66.43925511537691
PA,1982,1291496,708310,1191619,182395,136726,3510546,3.8947217897159017,96.1052782102841
RI,1982,197,28134,90122,0,6029,124482,4.843270513005897,95.15672948699411
SC,1982,271483,100978,309557,145677,52528,880223,5.967578670405113,94.03242132959488
SD,1982,36957,25014,97585,0,22170,181726,12.19968524041689,87.8003147595831
TN,1982,470661,212041,483674,111885,115351,1393612,8.277124479410338,91.72287552058967
TX,1982,931065,3503024,4020260,0,73520,8527869,0.8621145564032469,99.13788544359676
UT,1982,159560,110526,166643,0,9546,446275,2.1390398297014173,97.86096017029858
VA,1982,259723,154574,604004,192897,86992,1298190,6.701022192437162,93.29897780756284
VT,1982,1264,4340,53063,46222,16706,121595,13.739051770220815,86.26094822977919
WA,1982,74069,114396,582011,40206,390554,1201236,32.512678607700735,67.48732139229926
WI,1982,324150,315738,437256,113696,178401,1369241,13.029189163923663,86.97081083607634
WV,1982,807953,136141,192255,0,17928,1154277,1.5531800425721036,98.44681995742789
WY,1982,333591,90586,147840,0,6260,578277,1.082526194194132,98.91747380580587
US,1982,15269049,18367053,30179518,3131148,3747087,70693855,5.300442308599524,94.69955769140047
AK,1983,12403,239678,175955,0,5373,433409,1.239706605077421,98.76029339492258
AL,1983,532596,229993,415569,274203,202817,1655178,12.253485727819003,87.746514272181
AR,1983,177458,211726,284711,83380,71850,829125,8.66576209859792,91.33423790140208
AZ,1983,295442,120418,289170,0,73058,778088,9.389426388788928,90.61057361121107
CA,1983,32022,1601037,2979017,61214,363470,5036760,7.216345428410327,92.78365457158968
CO,1983,254698,207120,319872,8162,22556,812408,2.776437455071836,97.22356254492816
CT,1983,712,76286,428078,126367,45512,676955,6.723046583598614,93.27695341640138
DC,1983,3040,29633,43776,0,2564,79013,3.2450356270487135,96.75496437295129
DE,1983,73014,35491,122905,0,2224,233634,0.9519162450670707,99.04808375493293
FL,1983,318946,321009,1417209,161446,93021,2311631,4.024041899420799,95.9759581005792
GA,1983,584816,303129,685558,84771,121828,1780102,6.843877485672169,93.15612251432783
HI,1983,1040,0,205190,0,14322,220552,6.493706699553846,93.50629330044616
IA,1983,253663,223581,318754,25177,65552,886727,7.392579677848988,92.60742032215101
ID,1983,9466,36833,100634,0,61544,208477,29.52076248219228,70.47923751780772
IL,1983,848229,956269,1197343,305571,125462,3432874,3.6547219618313984,96.3452780381686
IN,1983,1105128,425164,636475,0,64951,2231718,2.9103587460422866,97.08964125395771
KS,1983,231156,345858,344475,0,10668,932157,1.144442406161194,98.85555759383881
KY,1983,637850,177528,449654,0,42736,1307768,3.267857907518765,96.73214209248124
LA,1983,106718,1472328,1560429,0,74654,3214129,2.3226821325466402,97.67731786745335
MA,1983,96877,185610,749558,66116,76623,1174784,6.5223053769884505,93.47769462301154
MD,1983,232600,148327,486226,127325,39536,1034014,3.8235459094364295,96.17645409056357
ME,1983,5895,2475,177768,62488,119381,368007,32.43987206765089,67.56012793234912
MI,1983,706594,710144,747226,178651,113600,2456215,4.625002290108968,95.37499770989103
MN,1983,211168,246314,460833,128164,55050,1101529,4.997598792224263,95.00240120777573
MO,1983,564360,264229,526714,0,31899,1387202,2.299520906111727,97.70047909388828
MS,1983,96091,244281,308251,0,45071,693694,6.497245183034594,93.5027548169654
MT,1983,42786,46619,148093,0,53494,290992,18.38332325287293,81.61667674712707
NC,1983,594999,141025,638834,134819,106003,1615680,6.560890770449594,93.43910922955041
ND,1983,213444,27302,124191,0,11502,376439,3.0554751234595776,96.94452487654043
NE,1983,104815,124993,195549,66321,11951,503629,2.3729769334172577,97.62702306658274
NH,1983,29383,9522,112789,0,28591,180285,15.858779155226447,84.14122084477356
NJ,1983,91632,407751,1177466,69006,61926,1807781,3.4255255476188764,96.57447445238112
NM,1983,263654,184595,208526,0,8570,665345,1.2880535661949815,98.71194643380502
NV,1983,140246,44691,138721,0,18097,341755,5.295313894456555,94.70468610554344
NY,1983,268018,738159,1606417,178577,248273,3039444,8.168368951689848,91.83163104831016
OH,1983,1321092,708534,1104882,53479,131158,3319145,3.9515598143497797,96.04844018565022
OK,1983,219296,655366,461895,0,22080,1358637,1.6251581548272276,98.37484184517277
OR,1983,9888,69791,308401,40186,253801,682067,37.21056729031019,62.78943270968981
PA,1983,1337526,658671,1227111,160505,158825,3542638,4.483241019827598,95.5167589801724
RI,1983,172,29445,92619,0,7379,129615,5.693013925857347,94.30698607414266
SC,1983,233856,104301,324249,278962,53388,994756,5.366944255676769,94.63305574432323
SD,1983,30709,23582,92479,0,22551,169321,13.318489732519888,86.6815102674801
TN,1983,547105,199046,477721,153222,118711,1495805,7.936261745347823,92.06373825465218
TX,1983,1016758,3335505,3995613,0,70196,8418072,0.8338726492241929,99.16612735077581
UT,1983,160238,118449,176813,0,11261,466761,2.412583742000724,97.58741625799928
VA,1983,275468,146846,627925,203636,87384,1341259,6.515072778635595,93.4849272213644
VT,1983,1164,4324,57921,31298,19404,114111,17.004495622683176,82.99550437731682
WA,1983,80210,111791,523972,38098,396700,1150771,34.472540583660866,65.52745941633913
WI,1983,352824,301789,431106,101404,199498,1386621,14.387348814131618,85.61265118586839
WV,1983,826149,120214,197978,0,15503,1159844,1.3366452729849876,98.66335472701502
WY,1983,313646,85247,114608,0,7598,521099,1.4580722664983046,98.5419277335017
US,1983,15867060,17212020,29997230,3202549,4069164,70348023,5.784333129020555,94.21566687097945
AK,1984,12883,258039,200815,0,6282,478019,1.3141737043925033,98.6858262956075
AL,1984,584607,239598,415550,262518,212240,1714513,12.379025414213832,87.62097458578617
AR,1984,163879,214432,263495,117188,72508,831502,8.720123343058706,91.2798766569413
AZ,1984,324862,126844,311927,0,78637,842270,9.336317332921746,90.66368266707825
CA,1984,37243,1739833,3213001,153366,339406,5482849,6.1903218563925435,93.80967814360746
CO,1984,286888,220950,325731,598,24590,858757,2.863440996696388,97.13655900330362
CT,1984,1489,83245,466486,154967,38459,744646,5.1647359953588685,94.83526400464113
DC,1984,2475,29802,47271,0,3226,82774,3.8973590741053954,96.1026409258946
DE,1984,72797,43852,129111,0,2927,248687,1.1769815068741027,98.8230184931259
FL,1984,378652,318172,1318892,261074,111200,2387990,4.656635915560785,95.34336408443922
GA,1984,681531,315287,728111,59331,130374,1914634,6.809343195618588,93.1906568043814
HI,1984,941,0,216113,0,14651,231705,6.323126389158628,93.67687361084137
IA,1984,251547,238314,312600,29274,69102,900837,7.6708660945320855,92.32913390546791
ID,1984,9020,40341,98726,0,63453,211540,29.99574548548738,70.00425451451262
IL,1984,833205,1056089,1098184,379243,123753,3490474,3.5454497011007673,96.45455029889924
IN,1984,1209499,451395,715014,0,62045,2437953,2.5449629258644446,97.45503707413556
KS,1984,274843,360762,407423,0,14622,1057650,1.3824989363210891,98.61750106367892
KY,1984,670985,193323,457857,0,52566,1374731,3.8237298787908327,96.17627012120917
LA,1984,119071,1661309,1459360,0,78816,3318556,2.3750088894085257,97.62499111059148
MA,1984,116021,208279,803719,11221,62946,1202186,5.235961822879322,94.76403817712068
MD,1984,270158,162784,517865,126334,45874,1123015,4.0848964617569665,95.91510353824303
ME,1984,4951,2528,207391,55552,118334,388756,30.439144347611354,69.56085565238864
MI,1984,747632,727492,782143,152652,107234,2517153,4.26013039334518,95.73986960665482
MN,1984,231376,256402,488996,90306,59197,1126277,5.255989423560989,94.74401057643901
MO,1984,593295,269127,537151,9978,35981,1445532,2.489118193163486,97.51088180683651
MS,1984,103950,276617,311980,1789,50468,744804,6.776010869973845,93.22398913002615
MT,1984,90265,47098,140833,0,52381,330577,15.84532499236184,84.15467500763816
NC,1984,558943,148682,705548,219376,115382,1747931,6.601061483548263,93.39893851645174
ND,1984,256659,22888,122464,0,12221,414232,2.950279070665714,97.04972092933428
NE,1984,124257,129488,187410,62676,13404,517235,2.591471961487525,97.40852803851247
NH,1984,34056,10116,134577,0,26181,204930,12.775581906016688,87.22441809398332
NJ,1984,84013,419435,1271714,60825,50546,1886533,2.679306431427386,97.32069356857261
NM,1984,252868,169781,202016,0,9267,633932,1.461828713489775,98.53817128651022
NV,1984,155582,44747,135708,0,23608,359645,6.564250858485451,93.43574914151455
NY,1984,299885,809500,1577749,229730,221079,3137943,7.045347860047171,92.95465213995283
OH,1984,1361844,768864,1096264,46759,127271,3401002,3.7421618687669103,96.25783813123309
OK,1984,230922,669277,456031,0,23450,1379680,1.6996694885770613,98.30033051142294
OR,1984,11814,81467,321691,51348,262776,729096,36.04134434971527,63.95865565028473
PA,1984,1462314,699645,1276013,233815,141849,3813636,3.7195212128268142,96.28047878717318
RI,1984,225,32535,102311,0,4933,140004,3.5234707579783433,96.47652924202166
SC,1984,244040,111184,347955,251939,57948,1013066,5.720061674165356,94.27993832583465
SD,1984,34414,24862,93209,0,23881,176366,13.540591724028442,86.45940827597155
TN,1984,555270,211280,519409,135551,131517,1553027,8.468429718221254,91.53157028177874
TX,1984,1074868,3556196,4198364,0,81397,8910825,0.9134619970653671,99.08653800293463
UT,1984,185637,124247,176034,0,11786,497704,2.3680741967112984,97.6319258032887
VA,1984,306947,148534,672067,184824,95326,1407698,6.7717649666334685,93.22823503336653
VT,1984,1394,4829,65699,36170,19369,127461,15.196020743600004,84.8039792564
WA,1984,82282,131958,598967,57614,395362,1266183,31.224712383597,68.775287616403
WI,1984,363416,307510,441010,116513,199049,1427498,13.943907452059477,86.05609254794052
WV,1984,898445,130959,199755,0,17622,1246781,1.4133997871318218,98.58660021286818
WY,1984,359414,89666,115379,0,8144,572603,1.4222768654722382,98.57772313452776
US,1984,17013578,18389567,30993084,3552531,4104641,74053401,5.542812274077729,94.45718772592227
AK,1985,11587,214042,237018,0,6520,469167,1.3896970588297983,98.6103029411702
AL,1985,662890,227780,410037,152028,200191,1652926,12.111310488188824,87.88868951181118
AR,1985,219791,199350,263729,105042,78057,865969,9.013833058689167,90.98616694131083
AZ,1985,342013,137315,317106,12005,73282,881721,8.311245847609392,91.68875415239062
CA,1985,45264,1925459,3125366,209565,306810,5612464,5.466582948238065,94.53341705176193
CO,1985,299070,209799,326922,-337,26625,862079,3.088464050278455,96.91153594972154
CT,1985,21316,80208,449592,135127,38531,724774,5.316277901801113,94.68372209819888
DC,1985,3489,29336,39526,0,3327,75678,4.396257829223817,95.60374217077619
DE,1985,71436,39443,122989,0,3019,236887,1.2744473103209548,98.72555268967905
FL,1985,472352,305057,1324401,249204,112772,2463786,4.577183245622794,95.42281675437721
GA,1985,725678,289572,771709,107602,126328,2020889,6.251110278694179,93.74888972130582
HI,1985,1124,0,232123,0,14573,247820,5.880477766120571,94.11952223387942
IA,1985,268806,191609,313930,20467,68965,863777,7.984120901575291,92.0158790984247
ID,1985,8870,41115,101978,0,55810,207773,26.86104546789044,73.13895453210957
IL,1985,811110,979924,1088921,415387,129310,3424652,3.7758581017866923,96.2241418982133
IN,1985,1193273,433689,712406,0,66672,2406040,2.77102625060265,97.22897374939735
KS,1985,259501,354756,391915,40960,14781,1061913,1.3919219371078422,98.60807806289216
KY,1985,716929,177681,444399,0,52476,1391485,3.77122283028563,96.22877716971438
LA,1985,159097,1441820,1426499,26102,79343,3132861,2.532605181015053,97.46739481898494
MA,1985,110246,221026,793263,65141,63608,1253284,5.075306155667829,94.92469384433217
MD,1985,256210,155581,484616,105434,44432,1046273,4.246692784770323,95.75330721522968
ME,1985,5093,2620,209101,56875,117108,390797,29.966453171339595,70.0335468286604
MI,1985,781884,717041,812411,142886,107203,2561425,4.185287486457733,95.81471251354226
MN,1985,226094,258499,481704,122923,61907,1151127,5.377947003241172,94.62205299675882
MO,1985,529684,263961,548611,85290,41483,1469029,2.823838059017215,97.17616194098278
MS,1985,109381,233010,315257,46014,50892,754554,6.74464650641306,93.25535349358694
MT,1985,99055,47312,151737,0,49266,347370,14.182571897400466,85.81742810259954
NC,1985,550505,138331,694797,205037,108761,1697431,6.407388577208735,93.59261142279126
ND,1985,301957,25551,118168,0,11942,457618,2.6096001468473706,97.39039985315263
NE,1985,115478,121224,189263,43911,14497,484373,2.9929413902096114,97.00705860979039
NH,1985,39719,10393,129981,0,25853,205946,12.553290668427646,87.44670933157235
NJ,1985,103310,375320,1191379,188752,51400,1910161,2.6908726541898824,97.30912734581011
NM,1985,268374,162312,188716,0,9621,629023,1.5295148190129773,98.47048518098703
NV,1985,126210,41626,135732,0,19426,322994,6.014353207799526,93.98564679220047
NY,1985,301368,782888,1676368,255910,224266,3240800,6.920081461367563,93.07991853863244
OH,1985,1389464,739854,1078973,20638,130101,3359030,3.8731717192165593,96.12682828078344
OK,1985,237168,603855,458247,0,29166,1328436,2.195514123375157,97.80448587662484
OR,1985,10045,85486,317849,73406,242736,729522,33.273294019919895,66.72670598008011
PA,1985,1409068,646711,1223123,278637,141404,3698943,3.8228218169352703,96.17717818306473
RI,1985,213,30725,114468,0,5081,150487,3.376371380916624,96.62362861908338
SC,1985,262653,100109,345974,338056,53689,1100481,4.87868486598133,95.12131513401867
SD,1985,34530,25454,96235,0,22670,178889,12.6726629362342,87.3273370637658
TN,1985,599665,196698,536800,102737,120407,1556307,7.736712615184536,92.26328738481547
TX,1985,1148998,3514363,4191428,0,86444,8941233,0.9668017822597845,99.03319821774022
UT,1985,199366,123750,174052,0,10781,507949,2.122457175818832,97.87754282418116
VA,1985,297127,144466,683369,236905,95965,1457832,6.582720093947725,93.41727990605227
VT,1985,1982,4958,68469,31860,20401,127670,15.979478342602022,84.02052165739798
WA,1985,93669,139974,607438,85377,375320,1301778,28.83133683316203,71.16866316683797
WI,1985,360704,311434,437393,116623,199954,1426108,14.020957739526038,85.97904226047396
WV,1985,871750,125018,194395,0,17607,1208770,1.4566046476997279,98.54339535230027
WY,1985,405502,86031,117402,0,7466,616401,1.211224511316497,98.7887754886835
US,1985,17540071,17713531,30867287,4075563,4018248,74214700,5.414355916011249,94.58564408398875
AK,1986,12150,208311,273084,0,5019,498564,1.0066912171757287,98.99330878282427
AL,1986,660525,210226,425299,122308,178850,1597208,11.197664925294639,88.80233507470535
AR,1986,224547,202982,263545,93900,71444,856418,8.342188043688946,91.65781195631105
AZ,1986,295888,105103,334630,105540,73384,914545,8.02409941555637,91.97590058444364
CA,1986,42519,1591045,3186566,277332,305255,5402717,5.65002756946181,94.34997243053819
CO,1986,295376,190320,334033,550,28372,848651,3.343188189255654,96.65681181074434
CT,1986,21216,80962,471128,197480,32925,803711,4.09662179564545,95.90337820435455
DC,1986,1359,29972,48221,0,3049,82601,3.6912386048595054,96.3087613951405
DE,1986,66423,33594,128005,0,2765,230787,1.1980744149367166,98.80192558506329
FL,1986,459413,298928,1503298,233119,117378,2612136,4.493563887944578,95.50643611205543
GA,1986,692512,286490,753485,76574,126582,1935643,6.539532341449327,93.46046765855067
HI,1986,395,0,227619,0,16641,244655,6.80182297520999,93.19817702479001
IA,1986,262130,163616,318227,31666,93274,868913,10.734561457821439,89.26543854217856
ID,1986,8617,35450,103914,0,60875,208856,29.146876316696673,70.85312368330332
IL,1986,804201,920227,1111357,450809,140300,3426894,4.094086365087453,95.90591363491255
IN,1986,1130131,396365,758023,0,68414,2352933,2.907605103927736,97.09239489607226
KS,1986,251692,307990,390775,73616,21759,1045832,2.0805444851563157,97.91945551484369
KY,1986,749913,173524,450380,0,49582,1423399,3.483352173213554,96.51664782678644
LA,1986,171903,1496106,1523944,112532,102343,3406828,3.0040553852439866,96.99594461475601
MA,1986,99755,188754,903068,25604,66884,1284065,5.208770584043642,94.79122941595635
MD,1986,275042,157872,485939,135704,41453,1096010,3.7821735203145956,96.2178264796854
ME,1986,9294,2549,245667,66032,101620,425162,23.901477554438074,76.09852244556193
MI,1986,811930,686621,848190,129671,110933,2587345,4.287522537581961,95.71247746241804
MN,1986,201382,244526,494237,116919,58838,1115902,5.272685235800276,94.72731476419972
MO,1986,512338,244317,561794,75854,35386,1429689,2.4750837419886422,97.52491625801136
MS,1986,108771,220195,335829,43233,49196,757224,6.496888635331157,93.50311136466884
MT,1986,133247,41148,133303,0,57423,365121,15.727115120740795,84.27288487925921
NC,1986,583153,140256,730781,214610,96382,1765182,5.460173511853169,94.53982648814683
ND,1986,310868,21367,118999,0,12655,463889,2.728023298677054,97.27197670132294
NE,1986,109935,101872,191720,81009,14841,499377,2.971902991126944,97.02809700887306
NH,1986,25052,10197,156111,0,29882,221242,13.506477070357347,86.49352292964265
NJ,1986,77882,350584,1272286,156254,43547,1900553,2.2912804852061477,97.70871951479386
NM,1986,241600,144532,188641,0,9956,584729,1.7026690997025973,98.2973309002974
NV,1986,161583,35772,141930,0,19991,359276,5.5642458722542,94.4357541277458
NY,1986,253341,749210,1793211,233632,220133,3249527,6.774308999432841,93.22569100056715
OH,1986,1431837,744329,1067822,254,118602,3362844,3.52683621363346,96.47316378636654
OK,1986,217945,570749,412111,0,24626,1225431,2.009578670688109,97.99042132931189
OR,1986,2911,72523,324839,74912,245960,721145,34.10687171095965,65.89312828904035
PA,1986,1318385,631709,1281549,421260,106997,3759900,2.845740578206867,97.15425942179313
RI,1986,705,26931,120640,0,4653,152929,3.042588390691105,96.95741160930889
SC,1986,263944,101474,351623,376882,80995,1174918,6.893672579703435,93.10632742029657
SD,1986,29205,23409,99566,0,24137,176317,13.689547803104636,86.31045219689537
TN,1986,605739,194003,551741,-1107,119013,1469389,8.099488971266288,91.90051102873372
TX,1986,1162745,3312909,4323366,0,99181,8898201,1.1146185616620707,98.88538143833793
UT,1986,188954,99706,188163,0,11874,488697,2.4297263948827186,97.57027360511728
VA,1986,303266,146586,741433,224429,85945,1501659,5.723336656324771,94.27666334367522
VT,1986,653,4954,69182,21776,16525,113090,14.61225572552834,85.38774427447166
WA,1986,63279,121783,675941,89276,387678,1337957,28.975370658399335,71.02462934160066
WI,1986,371384,281636,441874,118477,144821,1358192,10.662778163912025,89.33722183608798
WV,1986,877243,121128,182865,0,24024,1205260,1.9932628644441863,98.00673713555581
WY,1986,336607,78424,110962,0,8208,534201,1.5365003060645712,98.46349969393543
US,1986,17240884,16603236,32150914,4380109,3970572,74345715,5.340687086000854,94.65931291399914
AK,1987,4330,251512,231366,0,5897,493105,1.1958913416006733,98.80410865839933
AL,1987,660678,214611,460724,117450,181152,1634615,11.082242607586496,88.9177573924135
AR,1987,211011,172340,263304,118720,69821,835196,8.359834098822313,91.64016590117768
AZ,1987,282882,121301,341954,140532,52100,938769,5.549821095498467,94.45017890450153
CA,1987,44951,1992956,3319791,317298,278026,5953022,4.6703338237285195,95.32966617627147
CO,1987,296539,201536,333845,1812,19690,853422,2.307182144355313,97.69281785564469
CT,1987,21396,94504,465403,214482,28402,824187,3.446062604724413,96.55393739527558
DC,1987,1742,31422,43923,0,2229,79316,2.8102778758384184,97.18972212416158
DE,1987,70471,37254,131324,0,2162,241211,0.8963106989316407,99.10368930106836
FL,1987,586620,313553,1469980,196026,107266,2673445,4.012276295192159,95.98772370480785
GA,1987,710572,311055,791671,159333,123789,2096420,5.904780530618864,94.09521946938114
HI,1987,1573,159,228894,0,18170,248796,7.3031720767214905,92.6968279232785
IA,1987,287346,157888,309604,26348,100855,882041,11.434275730946748,88.56572426905325
ID,1987,8859,37780,105281,0,44656,196576,22.716913560149763,77.28308643985024
IL,1987,783231,873837,1159731,524124,150782,3491705,4.318291493697205,95.6817085063028
IN,1987,1166555,412377,798618,0,73207,2450757,2.9871178578700377,97.01288214212997
KS,1987,267406,343155,395580,67572,20455,1094168,1.869456975528438,98.13054302447156
KY,1987,746716,178271,481870,0,46185,1453042,3.178504131332749,96.82149586866726
LA,1987,172355,1560707,1502306,128688,102199,3466255,2.948398199209233,97.05160180079076
MA,1987,117626,231953,866120,11863,58107,1285669,4.519592523425548,95.48040747657446
MD,1987,288901,174143,516249,105147,36458,1120898,3.2525707067012344,96.74742929329877
ME,1987,6849,2747,234781,42216,97622,384215,25.40816990487097,74.59183009512903
MI,1987,840236,668667,879671,150251,112789,2651614,4.253597997295232,95.74640200270477
MN,1987,255980,239750,487282,120643,54444,1158099,4.701152492144454,95.29884750785554
MO,1987,528040,234492,583414,65615,30842,1442403,2.1382373719411287,97.86176262805887
MS,1987,122372,212336,349660,80577,45439,810384,5.607094908092954,94.39290509190705
MT,1987,132937,39561,133216,0,48477,354191,13.686683173767825,86.31331682623217
NC,1987,500936,153261,761413,298644,99145,1813399,5.467357156367683,94.53264284363232
ND,1987,319324,20616,116746,0,11163,467849,2.3860262606097264,97.61397373939027
NE,1987,116462,105571,200556,89684,13848,526121,2.6320941380404888,97.36790586195951
NH,1987,31550,11840,166118,0,27618,237126,11.646972495635232,88.35302750436477
NJ,1987,90538,418223,1273285,237006,40758,2059810,1.978726193192576,98.02127380680743
NM,1987,260668,164588,197109,0,7442,629807,1.1816318332441527,98.81836816675585
NV,1987,154875,41694,153921,0,11298,361788,3.1228233108892502,96.87717668911075
NY,1987,294305,801487,1853579,239397,205392,3394160,6.05133523463832,93.94866476536168
OH,1987,1433056,747082,1114991,78448,123816,3497393,3.5402369707951036,96.4597630292049
OK,1987,240662,617551,412384,0,25339,1295936,1.9552663094473801,98.04473369055262
OR,1987,3679,82487,332885,45399,228630,693080,32.987533906619724,67.01246609338027
PA,1987,1381080,658802,1340493,365282,100095,3845752,2.602741934477314,97.39725806552269
RI,1987,130,36824,121161,0,3302,161417,2.045633359559402,97.9543666404406
SC,1987,295325,108597,360750,410268,80494,1255434,6.411647286914326,93.58835271308567
SD,1987,14564,21361,102956,0,22460,161341,13.920826076446781,86.07917392355321
TN,1987,596507,206963,544135,-1124,123498,1469979,8.40134450900319,91.5986554909968
TX,1987,1203925,3435408,4370450,0,105587,9115370,1.158340253878888,98.84165974612111
UT,1987,273790,106906,192227,0,7117,580040,1.2269843459071788,98.77301565409282
VA,1987,337881,165106,774880,189468,82219,1549554,5.305978365387718,94.69402163461228
VT,1987,315,5113,75708,36927,16160,134223,12.039665333065123,87.96033466693488
WA,1987,95700,136071,701381,57728,361528,1352408,26.732169581960473,73.26783041803952
WI,1987,386561,281599,446969,118109,141882,1375120,10.317790447379139,89.68220955262086
WV,1987,871744,123734,193284,0,21455,1210217,1.772822559921072,98.22717744007893
WY,1987,428126,86042,125441,0,5739,645348,0.8892876401569386,99.11071235984306
US,1987,17949877,17646792,32818384,4753933,3777208,76946194,4.90889516900602,95.09110483099398
AK,1988,4362,288798,215477,0,6295,514932,1.2224915134425516,98.77750848655745
AL,1988,652717,243192,463721,137623,179389,1676642,10.699302534470686,89.30069746552931
AR,1988,218821,218787,276538,94309,73295,881750,8.312446838673093,91.6875531613269
AZ,1988,309041,128594,347703,243215,44931,1073484,4.185530478330371,95.81446952166962
CA,1988,50824,1860391,3515528,327209,283719,6037671,4.699146409269402,95.3008535907306
CO,1988,311372,218567,336407,6994,20585,893925,2.302765891993176,97.69723410800682
CT,1988,23112,90697,497770,235904,32125,879608,3.6521950687124263,96.34780493128757
DC,1988,781,33079,42714,0,2382,78956,3.016870155529662,96.98312984447034
DE,1988,69034,29928,144931,0,2310,246203,0.9382501431745348,99.06174985682547
FL,1988,611464,305758,1579829,277752,112999,2887802,3.912976028134893,96.08702397186511
GA,1988,698991,330859,825122,160615,124473,2140060,5.816332252366756,94.18366774763324
HI,1988,1242,0,268023,0,19756,289021,6.835489462703402,93.1645105372966
IA,1988,306130,196345,317882,33536,106668,960561,11.104760655491948,88.89523934450806
ID,1988,9710,41551,108434,0,40786,200481,20.344072505623974,79.65592749437603
IL,1988,745182,972786,1207204,733298,159564,3818034,4.179218938333184,95.82078106166682
IN,1988,1267244,459359,771753,0,77085,2575441,2.9930796317989814,97.00692036820102
KS,1988,269294,347982,432737,70503,21647,1142163,1.8952636357507642,98.10473636424923
KY,1988,821777,190884,511647,0,45231,1569539,2.8818015990682615,97.11819840093173
LA,1988,212090,1506424,1587062,146152,104615,3556343,2.941645392471986,97.05835460752802
MA,1988,116851,216402,877092,11841,60369,1282555,4.706932646163322,95.29306735383668
MD,1988,301217,177667,533782,124404,37065,1174135,3.1567920213604057,96.8432079786396
ME,1988,6906,3283,280038,53192,100455,443874,22.631422430689792,77.3685775693102
MI,1988,830904,763254,911829,188799,118420,2813206,4.209432227856759,95.79056777214325
MN,1988,303592,285439,501511,130279,56764,1277585,4.443070324088025,95.55692967591197
MO,1988,547281,254438,607354,94731,33753,1537557,2.1952356888232436,97.80476431117675
MS,1988,129622,216397,380731,101592,47412,875754,5.41384909460876,94.58615090539124
MT,1988,181480,42872,135516,0,46790,406658,11.505982914389978,88.49401708561003
NC,1988,515435,156550,799693,309008,95315,1876001,5.080754221346364,94.91924577865363
ND,1988,369782,25018,115240,0,10839,520879,2.080905546201709,97.9190944537983
NE,1988,139344,117991,215764,72391,13631,559121,2.4379338282768845,97.56206617172312
NH,1988,32754,12830,167452,0,28788,241824,11.904525605398968,88.09547439460103
NJ,1988,81127,409818,1259554,253285,43367,2047151,2.118407484352644,97.88159251564736
NM,1988,266124,185246,198678,0,7900,657948,1.2007027911020325,98.79929720889797
NV,1988,183513,48338,166087,0,9944,407882,2.4379599982347835,97.56204000176521
NY,1988,332998,812385,1901048,256306,198816,3501553,5.677937760759297,94.32206223924071
OH,1988,1474684,837475,1102825,89635,130203,3634822,3.582101131774816,96.41789886822518
OK,1988,269419,611171,427135,0,22982,1330707,1.7270518604020269,98.27294813959797
OR,1988,3115,89162,355757,67204,230898,746136,30.94583293126186,69.05416706873814
PA,1988,1466212,692470,1361537,401416,103307,4024942,2.566670525935529,97.43332947406446
RI,1988,4386,31217,125779,0,3528,164910,2.139348735674004,97.860651264326
SC,1988,301780,115146,399527,431984,78601,1327038,5.923040636364595,94.07695936363541
SD,1988,33805,24701,104269,0,22817,185592,12.294172162593215,87.70582783740679
TN,1988,610560,220847,551907,41776,118673,1543763,7.687255103276863,92.31274489672313
TX,1988,1264113,3665182,4620740,40201,103242,9693478,1.0650666355254532,98.93493336447455
UT,1988,337985,117778,196678,0,6478,658919,0.9831253917401077,99.0168746082599
VA,1988,342900,169565,803072,223036,81754,1620327,5.045524761359898,94.9544752386401
VT,1988,284,5495,78546,43615,15629,143569,10.886054788986481,89.11394521101352
WA,1988,99099,150514,735378,63616,361971,1410578,25.661182862627943,74.33881713737206
WI,1988,394074,319681,478838,121546,147044,1461183,10.063352776483164,89.93664722351683
WV,1988,915425,131544,201175,0,22189,1270333,1.7467073594089109,98.25329264059108
WY,1988,445702,86422,128596,0,5946,666666,0.891900891900892,99.10809910809911
US,1988,18885663,18460278,34173609,5586968,3822745,80929263,4.723563341976807,95.27643665802319
AK,1989,4719,321207,231924,0,12217,570067,2.1430814272708294,97.85691857272917
AL,1989,682145,253577,487915,121962,212018,1757617,12.062810043371224,87.93718995662877
AR,1989,203343,251139,275348,93599,98107,921536,10.64603010625738,89.35396989374262
AZ,1989,353144,151468,352657,83080,46201,986550,4.683087527241397,95.3169124727586
CA,1989,66427,2047845,3567746,344146,413507,6439671,6.421244190891119,93.57875580910888
CO,1989,323462,240556,320489,5600,18570,908677,2.043630464950692,97.9563695350493
CT,1989,23762,101745,508810,207033,32942,874292,3.767848727884963,96.23215127211503
DC,1989,1488,33757,43073,0,2514,80832,3.1101543942992875,96.88984560570071
DE,1989,61212,35883,141608,0,2515,241218,1.0426253430506844,98.95737465694931
FL,1989,636640,337182,1574562,221356,231399,3001139,7.71037262852537,92.28962737147464
GA,1989,666790,325560,797088,264167,191269,2244874,8.520255479817575,91.47974452018242
HI,1989,795,0,280097,0,28153,309045,9.1096765843162,90.8903234156838
IA,1989,317665,178635,312206,33221,72935,914662,7.9739838322790275,92.02601616772097
ID,1989,9757,46904,115788,0,59212,231661,25.559761893456386,74.44023810654362
IL,1989,720967,1007747,1104564,791821,131090,3756189,3.4899734811001255,96.51002651889988
IN,1989,1292598,465877,792209,0,66823,2617507,2.5529253598939756,97.44707464010602
KS,1989,267926,338559,411768,102753,17643,1138649,1.5494678342491848,98.45053216575081
KY,1989,767632,195826,527575,0,46166,1537199,3.0032546209046456,96.99674537909536
LA,1989,207701,1622888,1572980,131136,129814,3664519,3.5424567317020323,96.45754326829797
MA,1989,121873,260271,888008,31906,63995,1366053,4.684664504232266,95.31533549576774
MD,1989,295785,198687,571851,28777,42998,1138098,3.7780577770982817,96.22194222290172
ME,1989,6757,3930,258047,73464,130239,472437,27.567485188501323,72.43251481149868
MI,1989,790246,797304,911714,225547,110599,2835410,3.9006351815081417,96.09936481849186
MN,1989,324899,301369,503752,115634,58607,1304261,4.493502450813143,95.50649754918686
MO,1989,550407,252657,603202,88307,30156,1524729,1.9777940866868802,98.02220591331312
MS,1989,95648,232394,365367,82824,76403,852636,8.960799215609006,91.039200784391
MT,1989,179360,46671,143576,0,43593,413200,10.550096805421104,89.4499031945789
NC,1989,591439,166835,745095,309152,118549,1931070,6.139031728523564,93.86096827147644
ND,1989,363811,25922,118036,0,10923,518692,2.105874006153941,97.89412599384606
NE,1989,131097,116612,206709,85480,13935,553833,2.5161014240754884,97.48389857592451
NH,1989,31544,13606,173652,0,31154,249956,12.463793627678472,87.53620637232153
NJ,1989,94831,468254,1258947,243746,36567,2102345,1.7393434474360774,98.26065655256393
NM,1989,279835,205131,199118,0,8287,692371,1.196901661103657,98.80309833889635
NV,1989,170222,65538,175143,0,12453,423356,2.9414960458810078,97.05850395411899
NY,1989,363802,869652,1868573,241794,204793,3548614,5.771070057211069,94.22892994278894
OH,1989,1468632,847953,1138457,133993,111192,3700227,3.005004828082169,96.99499517191784
OK,1989,270329,620318,436023,0,33554,1360224,2.4667995859505494,97.53320041404945
OR,1989,6734,111807,352981,56080,214865,742467,28.93933333063961,71.06066666936039
PA,1989,1490936,714659,1363180,414489,87972,4071236,2.160817992373815,97.83918200762619
RI,1989,679,34628,112685,0,3771,151763,2.4847953717309226,97.51520462826907
SC,1989,302156,119649,381588,431569,83553,1318515,6.336901741732176,93.66309825826782
SD,1989,34299,25922,108171,0,20119,188511,10.672586745601052,89.32741325439895
TN,1989,566938,228488,567114,165130,122790,1650460,7.439744071349805,92.5602559286502
TX,1989,1335906,3886107,4651246,105722,117474,10096455,1.1635172939412892,98.83648270605872
UT,1989,349724,123414,190141,0,6522,669801,0.9737220458016634,99.02627795419833
VA,1989,384191,180403,788354,150955,95744,1599647,5.985320511337814,94.01467948866218
VT,1989,236,6064,77571,38171,12665,134707,9.401887058578989,90.59811294142101
WA,1989,96650,167828,761470,64745,353677,1444370,24.486592770550484,75.51340722944951
WI,1989,389885,332744,487333,114802,113775,1438539,7.909066073286856,92.09093392671315
WV,1989,932539,139427,209562,0,16425,1297953,1.2654541420220917,98.7345458579779
WY,1989,425603,86716,129670,0,5699,647688,0.8798989636985709,99.12010103630143
US,1989,19055165,19607316,34164741,5602161,4206142,82635525,5.089992469945583,94.91000753005441
AK,1990,12387,326826,226509,0,11545,577267,1.99994110177786,98.00005889822214
AL,1990,682496,252128,482913,127533,180825,1725895,10.477172713287889,89.52282728671211
AR,1990,212707,234465,265920,119387,84959,917438,9.260462287369828,90.73953771263017
AZ,1990,343415,130781,347239,217965,42902,1082302,3.963958303689728,96.03604169631028
CA,1990,84160,2101602,3505561,345955,383113,6420391,5.967128793246393,94.03287120675361
CO,1990,337375,232296,326470,0,17179,913320,1.8809398677352953,98.1190601322647
CT,1990,38511,108843,439477,209272,30723,826826,3.7157757496740547,96.28422425032595
DC,1990,1733,29095,37962,0,1283,70073,1.8309477259429452,98.16905227405705
DE,1990,59491,35620,139496,0,1652,236259,0.6992326218260468,99.30076737817396
FL,1990,633390,341993,1567401,230471,198400,2971655,6.676414321312534,93.32358567868746
GA,1990,714128,319199,815477,262401,204147,2315352,8.817104267515264,91.18289573248474
HI,1990,721,0,292762,0,27178,320661,8.475617552493132,91.52438244750687
IA,1990,334999,172149,304549,31868,67908,911473,7.450357827384903,92.5496421726151
ID,1990,10086,46786,120117,0,55987,232976,24.031230684705722,75.96876931529428
IL,1990,748159,951868,1101003,760711,101973,3663714,2.7833231524076387,97.21667684759237
IN,1990,1361800,456002,815938,0,57729,2691469,2.144888163304129,97.85511183669587
KS,1990,271741,352645,399100,83328,13776,1120590,1.2293523947206382,98.77064760527936
KY,1990,803503,191704,501555,0,31300,1528062,2.0483462058476687,97.95165379415234
LA,1990,208871,1654692,1611729,150230,120927,3746449,3.2277764891501257,96.77222351084987
MA,1990,114004,273581,806141,53647,56528,1303901,4.335298462076492,95.6647015379235
MD,1990,286482,180566,505810,13242,34476,1020576,3.3780923713667574,96.62190762863324
ME,1990,10413,4572,247447,51436,123037,436905,28.161041874091623,71.83895812590838
MI,1990,788043,879335,871782,228682,90787,2858629,3.175893059225244,96.82410694077475
MN,1990,325469,291771,502903,128458,54979,1303580,4.217539391521809,95.78246060847819
MO,1990,539572,241335,586562,84635,27826,1479930,1.8802240646517066,98.11977593534829
MS,1990,103944,261921,374048,78541,84868,903322,9.395099421911567,90.60490057808843
MT,1990,168848,44378,142439,0,48460,404125,11.991339313331272,88.00866068666873
NC,1990,568294,166744,715480,274130,121053,1845701,6.558646281277412,93.44135371872258
ND,1990,374517,28045,112054,0,9193,523809,1.7550290277563005,98.2449709722437
NE,1990,142021,106854,205026,79485,11735,545121,2.1527330629346513,97.84726693706534
NH,1990,31544,14265,159032,43182,33675,281698,11.95429147526784,88.04570852473216
NJ,1990,80800,447829,1127887,251538,25896,1933950,1.3390211742806173,98.66097882571938
NM,1990,275661,251470,210758,0,7282,745171,0.9772253616955034,99.0227746383045
NV,1990,165306,66759,168907,0,12619,413591,3.0510818659013372,96.94891813409866
NY,1990,349779,894964,1785597,249982,193907,3474229,5.581295878884207,94.4187041211158
OH,1990,1425314,775706,1087841,112845,78689,3480395,2.260921533331705,97.73907846666829
OK,1990,278807,628222,430559,0,30827,1368415,2.2527522717888946,97.74724772821111
OR,1990,15658,111724,346180,64273,199135,736970,27.020774251326376,72.97922574867363
PA,1990,1469705,680468,1311090,611503,71799,4144565,1.7323651577427306,98.26763484225727
RI,1990,129,40399,104515,0,4429,149472,2.9630967672875186,97.03690323271248
SC,1990,289222,134089,387626,453763,83563,1348263,6.197826388471685,93.80217361152832
SD,1990,34882,25446,108392,0,16782,185502,9.046802729889706,90.9531972701103
TN,1990,600526,227522,553207,148175,95002,1624432,5.848321136249471,94.15167886375053
TX,1990,1333671,3876543,4758496,167823,104748,10241281,1.0228017373998428,98.97719826260015
UT,1990,366842,126913,193227,0,6163,693145,0.8891357508169286,99.11086424918307
VA,1990,355067,192022,752480,252065,96721,1648355,5.867728735618238,94.13227126438176
VT,1990,201,6678,72019,38267,9942,127107,7.821756472892917,92.17824352710709
WA,1990,85575,167430,763170,60762,393303,1470240,26.750938622265753,73.24906137773425
WI,1990,394460,311236,478557,118793,89162,1392208,6.40435911875237,93.59564088124763
WV,1990,873485,129005,207656,0,9459,1219605,0.7755789784397408,99.22442102156026
WY,1990,459772,101316,122829,0,5023,688940,0.7290910674369321,99.27090893256307
US,1990,19167682,19627801,33500896,6104350,3864578,82265307,4.697700818158984,95.30229918184102
AK,1991,12675,367952,204675,0,11063,596365,1.8550719777317581,98.14492802226825
AL,1991,723921,261476,486549,166430,181640,1820016,9.980132042795228,90.01986795720477
AR,1991,215945,212680,261975,132746,85229,908575,9.380513441377982,90.61948655862201
AZ,1991,347261,128178,354652,263104,41462,1134657,3.65414393953415,96.34585606046585
CA,1991,89519,2208285,3254790,330684,376041,6259319,6.007698281554271,93.99230171844573
CO,1991,330609,268787,331410,0,20012,950818,2.104714046221254,97.89528595377875
CT,1991,38582,115683,426380,128355,31964,740964,4.313839808681664,95.68616019131834
DC,1991,1653,31287,35739,0,1347,70026,1.9235712449661555,98.07642875503385
DE,1991,56853,38967,139102,0,1733,236655,0.7322896199108406,99.26771038008916
FL,1991,650316,360992,1545238,215001,211898,2983445,7.102460410699711,92.8975395893003
GA,1991,643363,331599,780556,272752,197973,2226243,8.892695002297593,91.10730499770241
HI,1991,1063,0,266571,0,26765,294399,9.091403163733572,90.90859683626643
IA,1991,349273,188083,304543,43475,69801,955175,7.307666134477976,92.69233386552203
ID,1991,12271,52741,120517,0,54792,240321,22.799505661178173,77.20049433882183
IL,1991,757572,999478,1052333,753444,107987,3670814,2.9417725877693615,97.05822741223064
IN,1991,1338976,460594,783275,0,59103,2641948,2.2370992918861385,97.76290070811386
KS,1991,268537,373151,366669,61422,14232,1084011,1.3129018063469835,98.68709819365301
KY,1991,802748,196251,497931,0,33801,1530731,2.208160676173671,97.79183932382632
LA,1991,214236,1596766,1646691,146317,123489,3727499,3.3129183938077515,96.68708160619225
MA,1991,117917,283708,779969,46304,58748,1286646,4.5659800753276345,95.43401992467237
MD,1991,274761,182961,492584,94734,31790,1076830,2.9521837244504705,97.04781627554954
ME,1991,15409,5001,236445,65676,130449,452980,28.797960174842157,71.20203982515784
MI,1991,764149,889956,873873,283290,98544,2909812,3.386610543911428,96.61338945608857
MN,1991,301476,318200,509447,126427,58373,1313923,4.44264998786078,95.55735001213922
MO,1991,533887,258636,580164,104624,24654,1501965,1.6414497008918316,98.35855029910817
MS,1991,95302,257004,384670,95750,89510,922236,9.705758612762894,90.29424138723711
MT,1991,184213,46719,135154,0,58187,424273,13.714518717900974,86.28548128209903
NC,1991,567411,172818,705946,317795,96609,1860579,5.192415909241156,94.80758409075885
ND,1991,378936,36122,113247,0,9772,538077,1.8160969526666257,98.18390304733337
NE,1991,152008,111956,200522,84372,12098,560956,2.1566753898701503,97.84332461012986
NH,1991,34784,14098,146347,71164,29759,296152,10.048556146843513,89.95144385315649
NJ,1991,61891,495053,1125667,260072,35811,1978494,1.8100130705475983,98.1899869294524
NM,1991,234301,227349,226518,0,7678,695846,1.1034050637641086,98.89659493623589
NV,1991,180259,68175,174349,0,15903,438686,3.625144180575628,96.37485581942437
NY,1991,352268,916539,1667903,298252,188187,3423149,5.497481996839752,94.50251800316025
OH,1991,1413415,798398,1054525,155507,84217,3506062,2.402039667296243,97.59796033270376
OK,1991,312747,589960,433239,0,27715,1363661,2.032396614701161,97.96760338529884
OR,1991,32760,127778,359850,15363,196028,731779,26.78786901509882,73.21213098490118
PA,1991,1425228,666938,1266691,602575,76757,4038189,1.9007777991569983,98.099222200843
RI,1991,101,77996,95651,0,4515,178263,2.5327746083034617,97.46722539169654
SC,1991,290951,137393,399050,451945,85812,1365151,6.285898043513135,93.71410195648687
SD,1991,38674,26730,97389,0,17179,179972,9.545373724801635,90.45462627519836
TN,1991,565397,234594,526118,173895,102183,1602187,6.377719954037825,93.62228004596217
TX,1991,1333449,3823075,4782851,207582,106685,10253642,1.0404595752416557,98.95954042475834
UT,1991,344365,142458,205358,0,6843,699024,0.9789363455332005,99.0210636544668
VA,1991,379934,188469,731252,250424,100026,1650105,6.061796067522976,93.93820393247702
VT,1991,307,6982,77556,43072,9915,137832,7.193539961692495,92.8064600383075
WA,1991,89085,179237,761591,44346,380353,1454612,26.148072475684238,73.85192752431577
WI,1991,405601,333844,478345,115234,92278,1425302,6.4742770304118,93.5257229695882
WV,1991,802006,118823,199249,0,8916,1128994,0.7897296176950453,99.21027038230496
WY,1991,450771,103129,109136,0,5610,668646,0.8390089823314579,99.16099101766854
US,1991,18989140,20033047,32790251,6422132,3901433,82136003,4.749966954199123,95.25003304580088
AK,1992,12509,383887,212539,0,11938,620873,1.9227764776371334,98.07722352236287
AL,1992,775653,287947,491998,203111,186497,1945206,9.587519265311746,90.41248073468826
AR,1992,220706,226598,271674,118591,89408,926977,9.645115250971706,90.35488474902829
AZ,1992,369743,133771,365236,268149,41644,1178543,3.5335155357080734,96.46648446429192
CA,1992,91515,2294135,3245822,369043,377508,6378023,5.918887404451191,94.0811125955488
CO,1992,339652,259036,340901,0,18597,958186,1.9408549070848458,98.05914509291516
CT,1992,39166,126132,422371,175606,36453,799728,4.558174779425005,95.441825220575
DC,1992,1254,33187,34547,0,1411,70399,2.0042898336624098,97.99571016633759
DE,1992,46120,37201,147977,0,1783,233081,0.7649701176844101,99.23502988231559
FL,1992,649439,371137,1567742,262989,229941,3081248,7.462593079167921,92.53740692083208
GA,1992,613139,351369,795239,293149,200633,2253529,8.90305826994017,91.09694173005983
HI,1992,6750,0,272480,0,26202,305432,8.578668901752271,91.42133109824773
IA,1992,329253,179626,314515,35655,73277,932326,7.859589885941183,92.14041011405881
ID,1992,9620,50382,118730,0,49024,227756,21.52478968720912,78.47521031279088
IL,1992,698647,1003295,1078468,772156,113849,3666415,3.105185855938294,96.89481414406171
IN,1992,1291098,485267,779449,0,59138,2614952,2.2615329076786113,97.73846709232139
KS,1992,253303,338755,382061,88906,14180,1077205,1.316369678937621,98.68363032106238
KY,1992,812932,200899,528196,0,35252,1577279,2.2349882297298067,97.76501177027019
LA,1992,223538,1619499,1735750,108433,127019,3814239,3.3301269270226643,96.66987307297734
MA,1992,112044,344350,767820,49653,61424,1335291,4.600045982486215,95.39995401751379
MD,1992,247493,189963,494384,111662,34027,1077529,3.15787324517484,96.84212675482516
ME,1992,27500,5333,232092,56104,134693,455722,29.555957359969455,70.44404264003055
MI,1992,707470,964201,876843,197365,100867,2846746,3.5432384905432377,96.45676150945677
MN,1992,300773,312165,538597,116923,65245,1333703,4.892018687818802,95.1079813121812
MO,1992,522331,241227,600605,84647,26821,1475631,1.8175953202392738,98.18240467976072
MS,1992,86785,250696,399471,85587,90830,913369,9.944502167251132,90.05549783274887
MT,1992,194093,46615,139897,0,38500,419105,9.186242111165459,90.81375788883454
NC,1992,649160,186902,734150,238255,119993,1928460,6.222218765232362,93.77778123476764
ND,1992,399188,32147,117579,0,9616,558530,1.721662220471595,98.2783377795284
NE,1992,140933,103220,203315,91605,13687,552760,2.476119835009769,97.52388016499023
NH,1992,34679,16907,146937,82393,32553,313469,10.38475893948046,89.61524106051954
NJ,1992,62741,625894,1123664,226122,38434,2076855,1.8505865840417361,98.14941341595826
NM,1992,267469,211096,231443,0,7541,717549,1.0509386815395185,98.94906131846048
NV,1992,178836,81193,178800,0,15561,454390,3.4245912101938862,96.57540878980612
NY,1992,355983,1032726,1573605,252926,200666,3415906,5.874459074693507,94.1255409253065
OH,1992,1416870,838235,1095319,155028,82355,3587807,2.2954133263021115,97.70458667369789
OK,1992,328337,565655,468171,0,30828,1392991,2.2130796250657756,97.78692037493423
OR,1992,40780,127163,369828,47880,156161,741812,21.051290623500293,78.9487093764997
PA,1992,1473154,717188,1283797,629650,89723,4193512,2.1395670263969677,97.86043297360304
RI,1992,123,117757,104490,0,4770,227140,2.1000264154266093,97.89997358457339
SC,1992,288325,141758,387865,476813,87708,1382469,6.344301391206602,93.6556986087934
SD,1992,36042,27035,103259,0,16878,183214,9.212178108659819,90.78782189134019
TN,1992,590306,249234,561444,163909,99575,1664468,5.982391971488788,94.0176080285112
TX,1992,1324063,3768323,4986280,256502,117816,10452984,1.127103992505872,98.87289600749413
UT,1992,363056,132362,201745,0,6935,704098,0.9849481180176624,99.01505188198234
VA,1992,379542,220950,724875,244334,103325,1673026,6.175935102024715,93.82406489797529
VT,1992,508,7570,81981,39105,9628,138792,6.936999250677273,93.06300074932273
WA,1992,106087,180583,847703,59605,333174,1527152,21.81668884302283,78.18331115697717
WI,1992,395035,334867,476373,117350,93750,1417375,6.61433988887909,93.38566011112091
WV,1992,812735,137666,197870,0,10049,1158320,0.8675495545272464,99.13245044547276
WY,1992,491324,130703,113026,0,4857,739910,0.6564311875768675,99.34356881242313
US,1992,19117802,20723809,33468926,6479206,3931743,83721486,4.696217408276771,95.30378259172323
AK,1993,13630,375971,213456,0,11564,614621,1.8814846873113675,98.11851531268863
AL,1993,812948,302250,498060,187216,207205,2007679,10.320623964289112,89.67937603571089
AR,1993,200450,232682,284367,142032,102703,962234,10.673391295672362,89.32660870432764
AZ,1993,389839,118159,379251,231601,40750,1159600,3.514142807864781,96.48585719213521
CA,1993,84669,2213111,3155634,331724,416004,6201142,6.708506271909271,93.29149372809073
CO,1993,347233,286366,364253,0,20448,1018300,2.00805263674752,97.99194736325248
CT,1993,37303,125793,398029,229006,36817,826948,4.452154186236619,95.54784581376337
DC,1993,1279,33325,36925,0,1945,73474,2.647194926096306,97.3528050739037
DE,1993,63469,39346,147230,0,2492,252537,0.9867860947108741,99.01321390528912
FL,1993,654527,368011,1615819,271916,216027,3126300,6.909989444391133,93.09001055560887
GA,1993,655174,359989,872312,286059,209652,2383186,8.797131235245592,91.20286876475441
HI,1993,15575,0,239247,0,26238,281060,9.335373229915321,90.66462677008468
IA,1993,344102,196652,339473,33981,75750,989958,7.6518397750207585,92.34816022497924
ID,1993,9782,58294,128448,0,58875,255399,23.05216543526012,76.94783456473988
IL,1993,812832,1043124,1102832,823235,97273,3879296,2.5074910499224603,97.49250895007754
IN,1993,1319875,521235,801174,0,50485,2692769,1.874835903116829,98.12516409688317
KS,1993,302570,386513,352596,82977,13478,1138134,1.1842190814086917,98.81578091859132
KY,1993,921147,213053,526612,0,28339,1689151,1.6777067295937427,98.32229327040626
LA,1993,223457,1637028,1759008,151238,129759,3900490,3.3267358716468958,96.67326412835311
MA,1993,99579,350562,741938,45574,63660,1301313,4.891982174926401,95.1080178250736
MD,1993,261730,186562,517723,129208,37825,1133048,3.338340476308153,96.66165952369185
ME,1993,17377,5191,239297,60292,135766,457923,29.64821596643977,70.35178403356022
MI,1993,715473,924909,903733,299627,93903,2937645,3.196540085680877,96.80345991431912
MN,1993,325850,331511,547209,125902,70211,1400683,5.012625983181063,94.98737401681893
MO,1993,467752,280680,620426,88038,30680,1487576,2.062415634562537,97.93758436543746
MS,1993,99325,235310,422266,83019,92918,932838,9.96078633160313,90.03921366839687
MT,1993,161903,54265,149526,0,42724,408418,10.460851382652088,89.53914861734792
NC,1993,689419,192526,759709,249564,123182,2014400,6.115071485305799,93.8849285146942
ND,1993,399919,36274,115068,0,8499,559760,1.518329283978848,98.48167071602116
NE,1993,166207,122210,199079,71481,13949,572926,2.4346948820615575,97.56530511793844
NH,1993,37485,16932,147279,95028,32719,329443,9.931611841805715,90.06838815819428
NJ,1993,63133,651646,1089682,261888,36935,2103284,1.7560633751790058,98.24393662482099
NM,1993,270273,224999,232189,0,6812,734273,0.9277203437958361,99.07227965620416
NV,1993,172371,87493,190337,0,17150,467351,3.669618766195001,96.330381233805
NY,1993,326194,1021481,1559483,282445,218505,3408108,6.4113285142372245,93.58867148576277
OH,1993,1431633,864580,1100196,105152,64688,3566249,1.8138946551404571,98.18610534485954
OK,1993,355829,600099,457287,0,37904,1451119,2.6120531810278824,97.38794681897211
OR,1993,37131,141796,360397,-223,169830,708931,23.95578695246787,76.04421304753212
PA,1993,1487022,731693,1314251,623208,89126,4245300,2.099404046828257,97.90059595317175
RI,1993,72,76502,99496,0,5116,181186,2.8236177188082965,97.1763822811917
SC,1993,329445,145591,397231,485168,89878,1447313,6.209990513454933,93.79000948654506
SD,1993,36371,31708,106331,0,13327,187737,7.098760500061256,92.90123949993874
TN,1993,685674,263147,572761,34714,90319,1646615,5.4851316185022,94.5148683814978
TX,1993,1430676,3925163,4927256,130321,105422,10518838,1.0022209677532823,98.99777903224671
UT,1993,370982,149255,205702,0,7689,733628,1.0480788628569249,98.95192113714307
VA,1993,397271,248412,741831,238323,110056,1735893,6.3400221096576805,93.65997789034232
VT,1993,145,7221,81392,35421,11470,135649,8.455646558397039,91.54435344160296
WA,1993,97804,229613,759003,74946,333704,1495070,22.320292695325303,77.6797073046747
WI,1993,403278,352381,501031,120424,88684,1465798,6.050219743784615,93.94978025621539
WV,1993,821171,144246,197702,0,11000,1174119,0.9368726679322965,99.06312733206771
WY,1993,467772,110499,119969,0,5319,703559,0.7560133549567272,99.24398664504328
US,1993,19836126,21255357,33591507,6410499,4004770,85098259,4.706053974617742,95.29394602538225
AK,1994,12578,367592,219277,0,14301,613748,2.3301094260184962,97.6698905739815
AL,1994,773804,299250,525738,214054,255095,2067941,12.335700099761066,87.66429990023893
AR,1994,222169,247187,297298,145531,95703,1007888,9.49540028257108,90.50459971742892
AZ,1994,402390,139733,387714,242182,43382,1215401,3.5693569447449853,96.43064305525502
CA,1994,84616,2334777,3304777,352778,355772,6432720,5.530661990573194,94.4693380094268
CO,1994,359375,272152,371844,0,18625,1021996,1.8224141777462926,98.1775858222537
CT,1994,38584,134374,382203,210712,37501,803374,4.667937971604757,95.33206202839524
DC,1994,1169,31188,38150,0,1848,72355,2.55407366457052,97.44592633542948
DE,1994,57477,47255,141387,0,2421,248540,0.9740886778788123,99.02591132212119
FL,1994,663382,417702,1667888,278881,214035,3241888,6.602171327325312,93.39782867267469
GA,1994,685757,351897,880083,302346,211034,2431117,8.680536559943434,91.31946344005657
HI,1994,15740,0,257889,0,23020,296649,7.760012674912102,92.2399873250879
IA,1994,348935,198503,353616,42930,78020,1022004,7.634021001874748,92.36597899812526
ID,1994,9663,59069,132069,0,51607,252408,20.44586542423378,79.55413457576621
IL,1994,825387,1038608,1108660,759385,100045,3832085,2.610719751780036,97.38928024821996
IN,1994,1297228,523523,829694,0,48955,2699400,1.8135511595169296,98.18644884048307
KS,1994,300955,415552,346720,89145,13015,1165387,1.1167963946740438,98.88320360532596
KY,1994,896399,221269,528177,0,29855,1675700,1.7816434922718865,98.21835650772812
LA,1994,230869,1649015,1865978,133562,141614,4021038,3.5218269511504245,96.47817304884957
MA,1994,101755,381130,718173,40330,66997,1308385,5.120587594630021,94.87941240536998
MD,1994,268862,190998,520692,117432,39116,1137100,3.4399788936768974,96.5600211063231
ME,1994,17631,5268,253439,69317,132498,478153,27.710377222353515,72.28962277764649
MI,1994,800996,917002,904323,147836,97443,2867600,3.39806807086065,96.60193192913935
MN,1994,332848,327091,565003,127761,73382,1426085,5.145696084034261,94.85430391596574
MO,1994,539958,267762,652393,104588,25653,1590354,1.613037097400956,98.38696290259904
MS,1994,97270,266219,401065,100493,95203,960250,9.914397292371778,90.08560270762823
MT,1994,193689,53315,148716,0,38106,433826,8.783705909742615,91.21629409025738
NC,1994,632792,195303,769268,338080,138184,2073627,6.6638792801212565,93.33612071987875
ND,1994,402452,39325,116351,0,10675,568803,1.8767481887402142,98.12325181125979
NE,1994,160506,123981,206553,66321,15661,573022,2.7330538792576897,97.2669461207423
NH,1994,33580,19813,151807,64842,30267,300309,10.07861902240692,89.92138097759307
NJ,1994,65071,706021,1169163,231296,41646,2213197,1.8817122922179996,98.118287707782
NM,1994,278385,221479,221276,0,6686,727826,0.9186261551524677,99.08137384484753
NV,1994,180270,104940,200260,0,15814,501284,3.1546987336519816,96.84530126634802
NY,1994,316750,1094082,1493381,305527,218065,3427805,6.361651260792256,93.63834873920774
OH,1994,1386079,871347,1115705,114473,92928,3580532,2.5953685094840653,97.40463149051594
OK,1994,333445,595671,467102,0,32764,1428982,2.292821043232175,97.70717895676782
OR,1994,44583,152929,366782,0,152449,716743,21.269688019276085,78.73031198072391
PA,1994,1439646,738865,1345845,702446,95054,4321856,2.199379155622029,97.80062084437797
RI,1994,75,112094,104400,0,5001,221570,2.257074513697703,97.7429254863023
SC,1994,330813,148708,394542,464760,93678,1432501,6.5394718747142235,93.46052812528578
SD,1994,41355,31228,109047,0,22483,204113,11.014976998035403,88.98502300196459
TN,1994,622698,253995,592881,124717,103022,1697313,6.069711361428328,93.93028863857167
TX,1994,1389409,3885072,5149512,300448,104814,10829255,0.967878215075737,99.03212178492426
UT,1994,380866,146416,210443,0,7282,745007,0.9774404804250162,99.02255951957498
VA,1994,371724,260366,754018,265782,115358,1767248,6.527550179714448,93.47244982028555
VT,1994,124,7274,80554,45106,11897,144955,8.207374702493878,91.79262529750612
WA,1994,106884,263176,794789,70444,328652,1563945,21.01429398092644,78.98570601907356
WI,1994,424867,360440,514289,120370,92731,1512697,6.130176763753746,93.86982323624625
WV,1994,890802,155098,206789,0,10956,1263645,0.8670156570872357,99.13298434291276
WY,1994,490891,112252,119956,0,6161,729260,0.8448290047445356,99.15517099525546
US,1994,19903559,21757307,34457681,6693877,4056473,86868897,4.66964948340486,95.33035051659515
AK,1995,12882,432813,235221,0,13675,694591,1.9687845077174913,98.03121549228251
AL,1995,828277,332399,536342,218045,256556,2171619,11.814042886896827,88.18595711310317
AR,1995,237334,271956,306763,122486,95304,1033843,9.218420978813997,90.781579021186
AZ,1995,342889,127945,407598,283526,49010,1210968,4.047175482754293,95.9528245172457
CA,1995,84323,2109956,3313101,317794,419049,6244223,6.710987099595899,93.2890129004041
CO,1995,344201,288383,377856,0,21823,1032263,2.1140930169927623,97.88590698300723
CT,1995,40787,144867,363702,196995,43715,790066,5.533082046310055,94.46691795368994
DC,1995,143,33201,36938,0,1850,72132,2.56474241668053,97.43525758331947
DE,1995,52448,62738,126245,0,2475,243906,1.0147351848663009,98.9852648151337
FL,1995,686924,579310,1596852,301978,218817,3383881,6.466450800131565,93.53354919986843
GA,1995,723817,383385,924610,322151,220171,2574134,8.553206631822587,91.44679336817741
HI,1995,19914,0,252252,0,22171,294337,7.532522244909746,92.46747775509026
IA,1995,372311,210496,361136,39191,77467,1060601,7.304066279401962,92.69593372059803
ID,1995,8946,65687,140739,0,63648,279020,22.81126800946169,77.18873199053832
IL,1995,826679,1093289,1121251,824598,97004,3962821,2.447852173994233,97.55214782600576
IN,1995,1344410,538395,808870,0,51468,2743143,1.8762419604081888,98.1237580395918
KS,1995,289709,367750,353830,105723,12871,1129883,1.1391444954920111,98.860855504508
KY,1995,929379,245572,540851,0,28033,1743835,1.6075488793377815,98.39245112066222
LA,1995,216826,1737257,1819022,164812,145672,4083589,3.567254197226998,96.432745802773
MA,1995,105363,391216,674294,47133,66549,1284555,5.180704601982788,94.81929539801722
MD,1995,289562,198577,482528,135939,42126,1148732,3.6671738926050637,96.33282610739494
ME,1995,10995,5538,243867,2076,137743,400219,34.4169067435579,65.5830932564421
MI,1995,786684,970995,927445,256879,98922,3040925,3.2530233399376836,96.74697666006232
MN,1995,337972,357493,585943,139149,77675,1498232,5.1844440647376375,94.81555593526237
MO,1995,593728,281056,670662,86597,25012,1657055,1.509424853127989,98.490575146872
MS,1995,103786,295377,394455,84196,94383,972197,9.708217573187328,90.29178242681267
MT,1995,175304,59571,155992,0,53342,444209,12.00831140296572,87.99168859703428
NC,1995,662870,212010,815328,377308,130716,2198232,5.946415119059317,94.05358488094069
ND,1995,399757,41663,113693,0,12956,568069,2.2807088575507555,97.71929114244925
NE,1995,179482,133675,209703,78650,23542,625052,3.7664066349679706,96.23359336503204
NH,1995,35576,20046,150696,88042,30028,324388,9.256815911809316,90.74318408819069
NJ,1995,79902,713123,1146903,176576,44140,2160644,2.042909428855471,97.95709057114453
NM,1995,275217,219476,204586,0,7966,707245,1.1263423566090958,98.8736576433909
NV,1995,162497,112502,206975,0,17257,499231,3.4567164298691386,96.54328357013087
NY,1995,305274,1293868,1441869,276714,214169,3531894,6.063856956069463,93.93614304393054
OH,1995,1379803,923007,1116216,176182,86216,3681424,2.3419198657910636,97.65808013420893
OK,1995,369889,586432,434518,0,34109,1424948,2.393701384190862,97.60629861580914
OR,1995,20173,152111,358795,0,185887,716966,25.92689193071917,74.07310806928083
PA,1995,1484091,761428,1310049,698311,105281,4359160,2.4151671422934693,97.58483285770653
RI,1995,74,103499,98788,0,5015,207376,2.418312630198287,97.58168736980171
SC,1995,314509,155957,401400,516666,100846,1489378,6.771014477184435,93.22898552281556
SD,1995,37429,34738,110090,0,25427,207684,12.243119354403806,87.7568806455962
TN,1995,669028,264854,617783,165048,96931,1813644,5.3445439126973096,94.6554560873027
TX,1995,1364800,4037538,5121472,379842,110346,11013998,1.0018705287580405,98.99812947124195
UT,1995,361424,166860,227890,0,7891,764065,1.0327655369634783,98.96723446303652
VA,1995,385108,283873,750734,264092,119343,1803150,6.618584144413942,93.38141585558606
VT,1995,74,7259,80434,40541,12455,140763,8.848205849548531,91.15179415045147
WA,1995,69790,264474,815156,72938,374986,1597344,23.475594486848166,76.52440551315183
WI,1995,441615,385340,518512,115258,97801,1558526,6.275224154104583,93.72477584589542
WV,1995,871336,157816,206589,0,11336,1247077,0.909005618738859,99.09099438126114
WY,1995,463533,103848,129045,0,5464,701890,0.7784695607573836,99.22153043924261
US,1995,20098843,22720621,34345586,7075436,4296642,88537128,4.852926785698312,95.14707321430168
AK,1996,11152,443629,242048,0,13145,709974,1.8514762512430032,98.148523748757
AL,1996,890742,337764,539104,312018,246945,2326573,10.614109249956911,89.38589075004309
AR,1996,260060,274991,308927,140285,98641,1082904,9.108933017146487,90.89106698285352
AZ,1996,342839,125265,430032,302902,50240,1251278,4.015094966905836,95.98490503309417
CA,1996,80324,2017680,3380192,358119,404112,6240427,6.475710716590387,93.52428928340962
CO,1996,350712,315855,391154,0,23186,1080907,2.1450504067417455,97.85494959325825
CT,1996,41120,139102,402402,65384,51996,700004,7.42795755452826,92.57204244547174
DC,1996,575,34213,35034,0,1922,71744,2.6789696699375556,97.32103033006244
DE,1996,50779,55934,142557,0,2641,251911,1.0483861363735605,98.95161386362643
FL,1996,745817,561145,1605674,267514,238919,3419069,6.987837917280991,93.01216208271902
GA,1996,723082,393417,977292,314302,224444,2632537,8.525768108862287,91.4742318911377
HI,1996,20371,0,238601,0,21531,280503,7.6758537341846615,92.32414626581534
IA,1996,383702,223127,365993,41210,82247,1096279,7.502378500363502,92.4976214996365
ID,1996,7311,69191,149928,0,72019,298449,24.13109107418688,75.86890892581312
IL,1996,919858,1136534,1169912,732840,82764,4041908,2.047646804429987,97.95235319557001
IN,1996,1374505,576285,815036,0,46611,2812437,1.6573171239035756,98.34268287609642
KS,1996,338314,360921,371416,86176,11716,1168543,1.0026160783129077,98.99738392168709
KY,1996,952091,248009,527252,0,31382,1758734,1.7843516984376262,98.21564830156237
LA,1996,205405,1687569,1955598,165578,145919,4160069,3.5076100901211014,96.4923899098789
MA,1996,113698,386953,676073,55922,70193,1302839,5.3876956400599,94.6123043599401
MD,1996,292476,200827,502599,127010,49203,1172115,4.197796291319538,95.80220370868047
ME,1996,9827,5821,251711,53166,138415,458940,30.159715866997864,69.84028413300213
MI,1996,796303,1017096,949317,281789,111880,3156385,3.544561262330166,96.45543873766984
MN,1996,354571,374298,621533,127035,76729,1554166,4.93698871291741,95.06301128708259
MO,1996,631084,296414,701147,93376,22717,1744738,1.3020293018206746,98.69797069817932
MS,1996,127780,277468,417839,96886,85759,1005732,8.527023103570334,91.47297689642967
MT,1996,138751,63251,166438,0,62959,431399,14.594146022591614,85.40585397740838
NC,1996,744253,222106,852728,354142,132874,2306103,5.761841513583739,94.23815848641627
ND,1996,403951,45716,118582,0,14272,582521,2.450040427727069,97.54995957227293
NE,1996,178884,133525,232216,99325,27325,671275,4.070611895273919,95.92938810472609
NH,1996,36142,19295,155699,103399,34337,348872,9.842291728771583,90.15770827122842
NJ,1996,86606,718698,1120749,115826,41931,2083810,2.012227602324588,97.98777239767541
NM,1996,279149,233557,206197,0,7129,726032,0.9819126429689049,99.01808735703109
NV,1996,169470,126894,224190,0,17338,537892,3.223323641177039,96.77667635882295
NY,1996,311795,1229479,1510247,369977,240615,3662113,6.570387096192826,93.42961290380717
OH,1996,1447126,966665,1186247,146195,83243,3829476,2.173743875141142,97.82625612485886
OK,1996,373093,587957,461885,0,36724,1459659,2.515930090521142,97.48406990947886
OR,1996,20261,188209,361561,0,206337,776368,26.577215959441915,73.42278404055808
PA,1996,1543719,770927,1297896,721262,114722,4448526,2.5788766885930308,97.42112331140697
RI,1996,81,127144,96751,0,5490,229466,2.39251130886493,97.60748869113507
SC,1996,352579,153883,408506,457627,110726,1483321,7.4647362236495,92.5352637763505
SD,1996,33538,37342,115363,0,31749,217992,14.564295937465594,85.4357040625344
TN,1996,650760,289307,634454,240773,96168,1911462,5.031122774086014,94.96887722591399
TX,1996,1485577,4268665,5497675,375656,104877,11732450,0.8939053650345836,99.10609463496542
UT,1996,359984,168059,242234,0,8638,778915,1.1089785149855889,98.8910214850144
VA,1996,428703,269837,767473,276085,129674,1871772,6.927873694018288,93.07212630598171
VT,1996,42,7461,84587,39899,13335,145324,9.176048003082768,90.82395199691723
WA,1996,90901,283909,820381,58691,427620,1681502,25.43083505104365,74.56916494895636
WI,1996,454596,408079,543614,106305,109575,1622169,6.7548449021032955,93.2451550978967
WV,1996,913619,164286,185803,0,12182,1275890,0.9547845033662776,99.04521549663372
WY,1996,474076,107588,132719,0,6383,720766,0.885585613083858,99.11441438691614
US,1996,21002157,23151345,35592566,7086674,4481498,91314240,4.9077756109014326,95.09222438909856
AK,1997,11719,425394,256040,0,8109,701262,1.1563438486614133,98.84365615133859
AL,1997,867264,337431,524929,310336,221668,2261628,9.801258208688608,90.19874179131139
AR,1997,246786,264019,320440,149100,100134,1080479,9.267556333811207,90.73244366618879
AZ,1997,369872,137588,430092,307623,61559,1306734,4.710905203354317,95.28909479664568
CA,1997,82651,2185029,3292194,320194,376474,6256542,6.017285586830552,93.98271441316945
CO,1997,362423,311900,371516,0,24693,1070532,2.30661017139142,97.69338982860857
CT,1997,44982,148585,427410,-1309,47965,667633,7.184336304526589,92.81566369547342
DC,1997,983,34826,32573,0,1377,69759,1.9739388466004386,98.02606115339957
DE,1997,48586,48140,131417,0,2202,230345,0.955957368295383,99.04404263170461
FL,1997,751335,547201,1654266,241023,229786,3423611,6.71180224622482,93.28819775377518
GA,1997,767969,381712,938363,319170,233372,2640586,8.837886741806553,91.16211325819344
HI,1997,20513,0,230468,0,19937,270918,7.359053292878288,92.64094670712171
IA,1997,391698,208360,362421,43541,74583,1080603,6.901979727985208,93.0980202720148
ID,1997,6410,70801,146540,0,79204,302955,26.143816738459506,73.8561832615405
IL,1997,974920,1095556,1169735,535916,90517,3866644,2.340970619482942,97.65902938051705
IN,1997,1423469,559146,819146,0,43216,2844977,1.5190280975909471,98.48097190240905
KS,1997,310907,338569,374645,88469,10255,1122845,0.9133050421028727,99.08669495789712
KY,1997,977760,239307,563514,0,25533,1806114,1.4136981386556995,98.5863018613443
LA,1997,226065,1857072,1929691,141785,142648,4297261,3.319509799381513,96.6804902006185
MA,1997,122896,411405,725016,45234,65292,1369843,4.766385636894155,95.23361436310584
MD,1997,289686,219008,509621,138657,42372,1199344,3.5329313357969023,96.4670686642031
ME,1997,8966,6470,256438,0,137018,408892,33.50958199231093,66.49041800768907
MI,1997,781123,987593,978548,229964,104363,3081591,3.386659683261017,96.61334031673898
MN,1997,341636,360264,614840,113536,82546,1512822,5.456425144531214,94.54357485546879
MO,1997,670589,285391,696979,93970,20496,1767425,1.1596531677440345,98.84034683225596
MS,1997,132171,264210,432969,113467,84291,1027108,8.206634550602274,91.79336544939773
MT,1997,162568,61699,160519,0,62094,446880,13.89500537056928,86.10499462943072
NC,1997,765927,223419,858408,340563,129323,2317640,5.57994339069053,94.42005660930947
ND,1997,385988,53699,119917,0,15086,574690,2.6250674276566497,97.37493257234335
NE,1997,193334,132007,230493,97267,30558,683659,4.4697722109999285,95.53022778900007
NH,1997,44527,21146,159259,83736,31253,339921,9.194195121807715,90.80580487819229
NJ,1997,99889,735341,1134515,145951,40109,2155805,1.8605115026637382,98.13948849733626
NM,1997,288506,261881,217240,0,8002,775629,1.0316788052019716,98.96832119479802
NV,1997,166666,135497,214249,0,19826,536238,3.6972389125724026,96.3027610874276
NY,1997,325232,1357187,1462905,310304,284752,3740380,7.612916334703961,92.38708366529605
OH,1997,1407234,936758,1213463,160882,83483,3801820,2.195869346786539,97.80413065321346
OK,1997,392437,573479,457820,0,35316,1459052,2.420475760973564,97.57952423902644
OR,1997,16363,193771,358191,0,212960,781285,27.25765885688321,72.74234114311679
PA,1997,1569642,730639,1312478,709967,104346,4427072,2.3569980339149668,97.64300196608504
RI,1997,71,120513,102259,0,4295,227138,1.890920937932006,98.10907906206799
SC,1997,361385,158673,435897,471343,111865,1539163,7.267911195890234,92.73208880410976
SD,1997,42942,36772,111749,0,35035,226498,15.468127753887451,84.53187224611254
TN,1997,680608,291824,637049,258656,86761,1954898,4.438134368135831,95.56186563186417
TX,1997,1523201,4231566,5863047,392031,113638,12123483,0.9373378920892618,99.06266210791074
UT,1997,375105,172248,245399,0,10114,802866,1.2597369922253527,98.74026300777464
VA,1997,432781,259571,799733,284220,119055,1895360,6.281392453148742,93.71860754685126
VT,1997,2695,8309,86534,44776,12689,155003,8.186293168519319,91.81370683148069
WA,1997,80465,268141,822643,65526,452482,1689257,26.78585910847195,73.21414089152805
WI,1997,486597,404955,545521,41093,111497,1589663,7.013876526030989,92.98612347396902
WV,1997,937708,170349,198854,0,9853,1316764,0.7482737984938835,99.25172620150612
WY,1997,468350,107907,131308,0,6890,714455,0.9643714439677796,99.03562855603222
US,1997,21443603,23372324,36069260,6596992,4460893,91943072,4.851798947940308,95.14820105205969
AK,1998,16471,434437,258658,0,6084,715650,0.8501362397820164,99.14986376021798
AL,1998,856479,341973,518605,300698,245667,2263422,10.853786876684948,89.14621312331505
AR,1998,254658,272888,321517,137403,93780,1080246,8.681355913375286,91.31864408662472
AZ,1998,386770,161086,468094,317888,53679,1387517,3.868709356353832,96.13129064364617
CA,1998,66157,2418688,3315357,362928,392331,6555461,5.984796492573139,94.01520350742686
CO,1998,364889,328897,402345,0,21478,1117609,1.921781231181925,98.07821876881808
CT,1998,32569,134891,417161,34022,46427,665070,6.980768941615168,93.01923105838483
DC,1998,155,31235,33591,0,1221,66202,1.8443551554333706,98.15564484456662
DE,1998,45817,42322,132144,0,1935,222218,0.8707665445643468,99.12923345543565
FL,1998,749474,529565,1837091,326432,204260,3646822,5.601041125670515,94.39895887432948
GA,1998,767394,378549,961594,329212,221057,2657806,8.317273721257308,91.68272627874269
HI,1998,18223,0,233508,0,19091,270822,7.049279600623287,92.9507203993767
IA,1998,424859,184856,386346,39525,72818,1108404,6.569626237364715,93.43037376263528
ID,1998,8783,71912,152565,0,72052,305312,23.599465464835973,76.40053453516403
IL,1998,949046,975542,1164470,583254,90544,3762856,2.406257374717502,97.5937426252825
IN,1998,1447976,527435,816296,0,41269,2832976,1.4567366613765877,98.54326333862342
KS,1998,309382,325041,377110,109219,9818,1130570,0.8684115092387026,99.1315884907613
KY,1998,958990,212107,580206,0,22665,1773968,1.2776442416097697,98.72235575839024
LA,1998,225283,1679040,1850600,172341,140327,4067591,3.44987979371574,96.55012020628426
MA,1998,109862,367039,745338,59782,59419,1341440,4.429493678435114,95.57050632156489
MD,1998,303896,195457,542867,139851,40856,1222927,3.340837188155957,96.65916281184404
ME,1998,7294,5789,253121,0,126027,392231,32.13081067024279,67.8691893297572
MI,1998,826852,871603,982332,131076,99402,2911265,3.4143920254597226,96.58560797454028
MN,1998,357030,337078,613318,122158,80365,1509949,5.322365192466766,94.67763480753324
MO,1998,695687,261463,744664,89349,22132,1813295,1.2205405077497042,98.7794594922503
MS,1998,125930,252445,461773,96418,64175,1000741,6.4127481536181685,93.58725184638183
MT,1998,186099,61398,159543,0,52849,459889,11.491686037282909,88.5083139627171
NC,1998,754322,222659,868642,406822,124075,2376520,5.220869170046959,94.77913082995305
ND,1998,409226,45753,112773,0,11747,579499,2.027095818974666,97.97290418102533
NE,1998,204797,131114,243768,86643,31247,697569,4.479413506047431,95.52058649395256
NH,1998,38623,19233,168062,87988,29751,343657,8.657178523935203,91.3428214760648
NJ,1998,86235,696034,1114078,284643,39413,2220403,1.7750381349691926,98.2249618650308
NM,1998,290367,241406,228647,0,8439,768859,1.0976004703072995,98.9023995296927
NV,1998,184243,154656,220582,0,22416,581897,3.8522281434686896,96.1477718565313
NY,1998,337438,1266346,1498639,328512,261254,3692189,7.075856625974456,92.92414337402555
OH,1998,1450165,842630,1200238,172847,83194,3749074,2.2190546252221215,97.78094537477787
OK,1998,370064,583964,465618,0,36785,1456431,2.5256946604404877,97.4743053395595
OR,1998,36133,239269,385362,0,184703,845467,21.846269576458926,78.15373042354108
PA,1998,1466042,667150,1348264,641517,95530,4218503,2.264547399871471,97.73545260012853
RI,1998,59,134033,96345,0,4137,234574,1.7636225668658931,98.23637743313411
SC,1998,373368,164881,452309,511535,105738,1607831,6.576437448960743,93.42356255103925
SD,1998,41015,33370,110149,0,24153,208687,11.573792330140353,88.42620766985965
TN,1998,651838,287443,671267,297814,85535,1993897,4.289840448127461,95.71015955187254
TX,1998,1488589,4377957,5934436,405846,105346,12312174,0.8556246849662781,99.14437531503373
UT,1998,396129,177960,250190,0,10526,834805,1.2608932624984277,98.73910673750157
VA,1998,438490,271387,811633,285716,117403,1924629,6.1000327855394465,93.89996721446056
VT,1998,53,7827,83046,35226,12187,138339,8.80951864622413,91.19048135377587
WA,1998,103476,303307,822396,72556,363145,1664880,21.812082552496275,78.18791744750372
WI,1998,472029,372061,565384,98586,98824,1606884,6.150039455243814,93.84996054475619
WV,1998,978340,151873,213149,0,8842,1352204,0.653895418146966,99.34610458185304
WY,1998,516261,116505,128915,0,6611,768292,0.8604801299505918,99.13951987004941
US,1998,21583324,22911552,36724106,7067809,4172729,92459520,4.5130333793642885,95.48696662063571
AK,1999,16394,422817,275510,0,5040,719761,0.7002324382677028,99.2997675617323
AL,1999,866512,349076,536391,322826,237358,2312163,10.26562573659383,89.73437426340617
AR,1999,267022,257666,350550,135009,92463,1102710,8.385069510569416,91.61493048943059
AZ,1999,403262,167770,494547,317843,49643,1433065,3.464113630575026,96.53588636942497
CA,1999,69547,2379558,3423775,348736,372132,6593748,5.6437097687081765,94.35629023129182
CO,1999,364236,330896,412819,0,21743,1129694,1.9246804886987097,98.07531951130129
CT,1999,15231,155870,442382,132456,46716,792655,5.893610713362055,94.10638928663795
DC,1999,151,32964,33414,0,1258,67787,1.8558130615014679,98.14418693849854
DE,1999,35915,58089,136124,0,1999,232127,0.8611665166051342,99.13883348339486
FL,1999,716280,583448,1837301,329450,203241,3669720,5.5383244498217845,94.46167555017821
GA,1999,782617,347107,1013518,328946,212369,2684557,7.910765165351304,92.08923483464869
HI,1999,17691,0,229893,0,19430,267014,7.276772004464186,92.72322799553581
IA,1999,432009,201472,401164,38041,75731,1148417,6.5943816575338055,93.4056183424662
ID,1999,7976,73361,165044,0,75416,321797,23.435892814414057,76.56410718558594
IL,1999,958832,1011875,1273008,854224,92867,4190806,2.21596991127721,97.78403008872279
IN,1999,1477167,558192,844706,0,44825,2924890,1.5325362663211266,98.46746373367887
KS,1999,329308,302023,420488,95687,10058,1157564,0.8688936421657896,99.13110635783421
KY,1999,987592,225390,606779,0,21088,1840849,1.1455583809427063,98.8544416190573
LA,1999,227687,1558295,1972528,137016,142980,4038506,3.540418164539065,96.45958183546094
MA,1999,113610,361211,715870,47218,58519,1296428,4.513864248535206,95.4861357514648
MD,1999,305186,202525,568415,139114,41184,1256424,3.2778743481499877,96.72212565185
ME,1999,6864,6646,266171,0,133593,413274,32.3255273740908,67.6744726259092
MI,1999,832638,947027,1034821,152473,101323,3068282,3.3022714339816224,96.69772856601838
MN,1999,341475,351078,641002,139148,87458,1560161,5.605703513932216,94.39429648606779
MO,1999,687170,269052,769363,89730,21279,1836594,1.1586120830188926,98.8413879169811
MS,1999,137608,317777,472228,88075,65132,1080820,6.02616531892452,93.97383468107547
MT,1999,186770,63624,173185,0,62836,486415,12.918187144722099,87.0818128552779
NC,1999,742398,224741,863324,392121,117528,2340112,5.022323717839146,94.97767628216086
ND,1999,411323,53404,123412,0,12906,601045,2.14726018850502,97.85273981149498
NE,1999,198490,121364,246043,105452,32897,704246,4.6712370393300064,95.32876296066999
NH,1999,35408,20383,173701,90667,29290,349449,8.38176672418579,91.6182332758142
NJ,1999,88984,737575,1159974,302746,40356,2329635,1.732288534469992,98.26771146553001
NM,1999,298105,231312,238816,0,8572,776805,1.1034944419770727,98.89650555802292
NV,1999,181616,159981,225010,0,22270,588877,3.7817744622391434,96.21822553776086
NY,1999,317998,1308185,1522476,386844,251643,3787146,6.644660649470604,93.35533935052939
OH,1999,1382205,871913,1269430,171610,90671,3785829,2.395010445532537,97.60498955446747
OK,1999,360598,550768,491891,0,33680,1436937,2.3438745052845045,97.6561254947155
OR,1999,38604,246996,393569,0,199304,878473,22.68754987347363,77.31245012652637
PA,1999,1414957,713447,1343271,743282,96960,4311917,2.24865181774139,97.75134818225861
RI,1999,41,120719,97394,0,4360,222514,1.9594272719918746,98.04057272800813
SC,1999,402153,167960,457386,531002,85469,1643970,5.198939153390877,94.80106084660912
SD,1999,46304,36004,113682,0,27606,223596,12.3463747115333,87.6536252884667
TN,1999,648342,286363,688943,284525,78673,1986846,3.959692900204646,96.04030709979536
TX,1999,1530426,4138068,5842281,384141,88905,11983821,0.7418752332832742,99.25812476671672
UT,1999,384060,169255,256387,0,11624,821326,1.4152723766202457,98.58472762337975
VA,1999,444542,287144,827413,295742,118184,1973025,5.98998998998999,94.01001001001
VT,1999,2016,8128,83770,42418,12559,148891,8.435029652564628,91.56497034743538
WA,1999,96875,302262,848406,63598,423236,1734377,24.402768256267237,75.59723174373276
WI,1999,480722,385142,607396,120120,102773,1696153,6.059182161043255,93.94081783895675
WV,1999,993017,147675,204099,0,8470,1353261,0.625895522002038,99.37410447799796
WY,1999,496169,101660,147779,0,6108,751716,0.8125409064061427,99.18745909359386
US,1999,21582103,22925260,37736847,7610256,4201726,94056192,4.467250811089609,95.53274918891039
AK,2000,16455,437972,275255,0,5574,735256,0.7581033000750759,99.24189669992492
AL,2000,904181,368472,559735,327143,223807,2383338,9.390485109539645,90.60951489046036
AR,2000,267579,256114,357586,121516,92540,1095335,8.448556834210539,91.55144316578946
AZ,2000,432810,208137,502693,316839,45505,1505984,3.0216124474097996,96.9783875525902
CA,2000,70012,2456438,3571465,366845,370066,6834826,5.414417279971722,94.58558272002828
CO,2000,387879,366094,438600,0,22119,1214692,1.8209554356166007,98.1790445643834
CT,2000,36246,163696,428736,170674,47338,846690,5.590948280952887,94.40905171904711
DC,2000,177,34377,34442,0,1353,70349,1.9232682767345661,98.07673172326544
DE,2000,50147,50175,130824,0,2288,233434,0.9801485644764687,99.01985143552353
FL,2000,760439,574460,1907826,336766,194517,3774008,5.154122619771871,94.84587738022813
GA,2000,819530,421262,1013420,338660,205344,2798216,7.338389888414619,92.66161011158538
HI,2000,17653,76,235191,0,17784,270704,6.569537206690703,93.4304627933093
IA,2000,445888,203042,395259,46439,71239,1161867,6.131424681138203,93.8685753188618
ID,2000,13732,74518,167339,0,66584,322173,20.667157086410096,79.3328429135899
IL,2000,1016555,1040261,1259616,932749,96707,4345888,2.2252529287455176,97.77474707125448
IN,2000,1595037,576102,850050,0,44680,3065869,1.457335587397896,98.54266441260211
KS,2000,362797,314868,389363,94495,9816,1171339,0.8380152970233212,99.16198470297668
KY,2000,997621,234171,594541,0,20504,1846837,1.1102225047473058,98.88977749525269
LA,2000,253263,1625863,2166184,164734,138738,4348782,3.190272586669095,96.8097274133309
MA,2000,114658,357716,739514,57487,62221,1331596,4.672663480515111,95.32733651948489
MD,2000,312162,219031,546998,144204,42360,1264755,3.3492652727208037,96.6507347272792
ME,2000,9980,48041,259350,0,138647,456018,30.40384370792381,69.59615629207619
MI,2000,799800,971656,991862,196925,108675,3068918,3.541150333765842,96.45884966623416
MN,2000,373775,367359,657500,135160,93403,1627197,5.740116285858442,94.25988371414155
MO,2000,688905,288058,674357,104205,19220,1774745,1.0829724833708505,98.91702751662915
MS,2000,147481,312078,455825,111534,75389,1102307,6.839201783169298,93.1607982168307
MT,2000,176779,69590,165428,0,48460,460257,10.52890015795523,89.47109984204477
NC,2000,786114,240727,906487,408054,118207,2459589,4.805965549528803,95.1940344504712
ND,2000,424563,53421,119333,0,11741,609058,1.9277310206909686,98.07226897930903
NE,2000,206938,127260,221604,89988,33498,679288,4.931339873514621,95.06866012648538
NH,2000,44033,26207,168959,82617,28931,350747,8.2483955671752,91.7516044328248
NJ,2000,114734,617898,1190347,298041,40916,2261936,1.808892912973665,98.19110708702634
NM,2000,305513,259018,231369,0,9109,805009,1.131540144271679,98.86845985572832
NV,2000,199339,194126,233204,0,21320,647989,3.2901793085993742,96.70982069140062
NY,2000,330844,1278811,1604698,328597,261307,3804257,6.868805130673349,93.13119486932665
OH,2000,1428454,926922,1251551,175013,94967,3876907,2.4495557928008074,97.55044420719919
OK,2000,381089,546706,511661,0,31931,1471387,2.1701292725843033,97.8298707274157
OR,2000,38700,230962,378765,0,178605,827032,21.59589955406804,78.40410044593196
PA,2000,1508091,727214,1407638,769361,99079,4511383,2.196200145276958,97.80379985472304
RI,2000,52,91787,97168,0,4486,193493,2.3184301240871763,97.68156987591283
SC,2000,432195,165026,472260,530708,82051,1682240,4.877484782195168,95.12251521780483
SD,2000,50602,38117,115982,0,24637,229338,10.742659306351324,89.25734069364867
TN,2000,705059,280666,697006,269327,77076,2029134,3.7984677207123827,96.20153227928762
TX,2000,1548184,4550106,5767121,391670,92516,12349597,0.7491418545884534,99.25085814541154
UT,2000,403068,173439,267708,0,10305,854520,1.2059401769414408,98.79405982305856
VA,2000,506961,277688,869435,295361,112213,2061658,5.4428523062506,94.5571476937494
VT,2000,26,10545,88067,47432,13014,159084,8.180583842498303,91.81941615750169
WA,2000,106240,297569,835014,89744,366576,1695143,21.62507823823713,78.37492176176288
WI,2000,499233,397553,600129,120059,102202,1719176,5.944824729986924,94.05517527001308
WV,2000,977817,157926,206488,0,9592,1351823,0.7095603492469058,99.2904396507531
WY,2000,506147,105975,145728,0,6478,764328,0.847541893009284,99.15245810699072
US,2000,22575538,23815293,38156681,7862349,4095636,96505497,4.243940632728932,95.75605936727106
AK,2001,15911,413049,289334,0,8119,726413,1.1176837418933858,98.88231625810661
AL,2001,842337,344004,534772,317019,195008,2233140,8.732457436613917,91.26754256338609
AR,2001,273982,231590,353382,154356,76385,1089695,7.009759611634448,92.99024038836555
AZ,2001,424023,244424,514052,299966,39755,1522220,2.611646148388538,97.38835385161146
CA,2001,67839,2513856,3585715,346911,325466,6839787,4.758423032764032,95.24157696723597
CO,2001,400028,464062,453248,0,19783,1337121,1.4795220477428743,98.52047795225712
CT,2001,39991,149344,418855,161112,27939,797241,3.50446100990792,96.49553899009209
DC,2001,741,30577,33414,0,865,65597,1.318657865451164,98.68134213454884
DE,2001,38335,51817,138478,0,1324,229954,0.5757673273785192,99.42423267262149
FL,2001,725890,569757,1941855,329825,157150,3724477,4.219384359199963,95.78061564080004
GA,2001,772021,362643,1011020,351739,174128,2671551,6.517861721524313,93.48213827847569
HI,2001,17774,134,239817,0,10245,267970,3.8231891629660035,96.176810837034
IA,2001,443921,193445,381227,40234,67480,1126307,5.991261707509587,94.00873829249042
ID,2001,11395,81804,155395,0,54613,303207,18.01178732680974,81.98821267319026
IL,2001,983729,958425,1230341,964500,99838,4236833,2.3564299088493694,97.64357009115064
IN,2001,1569235,505274,801895,0,49201,2925605,1.6817376235000965,98.3182623764999
KS,2001,354647,273862,377245,108050,10471,1124275,0.9313557626025661,99.06864423739744
KY,2001,1013055,216705,627963,0,26846,1884569,1.4245166932067757,98.57548330679323
LA,2001,239990,1347228,1965937,181041,131058,3865254,3.3906697981555673,96.60933020184443
MA,2001,109014,364097,739924,53719,43138,1309892,3.293248603701679,96.70675139629832
MD,2001,318851,184783,566433,142612,25097,1237776,2.0275881904318713,97.97241180956813
ME,2001,7875,101190,227875,0,127845,464785,27.50626633819938,72.49373366180062
MI,2001,789703,924496,980720,278941,88207,3062067,2.88063585806581,97.11936414193418
MN,2001,353305,344882,652093,123113,96084,1569477,6.122039379997286,93.87796062000271
MO,2001,716378,288586,722516,87557,25495,1840532,1.3851973233825872,98.61480267661742
MS,2001,198275,340904,479661,103635,56104,1178579,4.760308812561568,95.23969118743844
MT,2001,184401,66483,156398,0,34881,442163,7.88871977076327,92.11128022923673
NC,2001,756311,215600,900456,394485,113930,2380782,4.78540244339885,95.21459755660115
ND,2001,420001,57334,137162,0,10274,624771,1.6444425237406985,98.3555574762593
NE,2001,226691,124051,215468,91127,35610,692947,5.138921158472438,94.86107884152756
NH,2001,40125,24757,166694,90778,23332,345686,6.7494778498406065,93.2505221501594
NJ,2001,112207,573040,1193427,318190,29896,2226760,1.342578454795308,98.6574215452047
NM,2001,297096,259626,238316,0,6274,801312,0.7829659358651812,99.21703406413482
NV,2001,188572,181256,247451,0,20290,637569,3.182400649968866,96.81759935003113
NY,2001,306993,1204885,1625732,421845,191219,3750674,5.098257006607346,94.90174299339266
OH,2001,1362828,836825,1257823,161488,64839,3683803,1.7601104076412337,98.23988959235876
OK,2001,376112,505220,581673,0,32195,1495200,2.1532236490101657,97.84677635098983
OR,2001,43365,235634,352498,0,152639,784136,19.465883469194118,80.53411653080587
PA,2001,1392203,668960,1431355,769971,85698,4348187,1.9708903963881959,98.0291096036118
RI,2001,50,98571,99767,0,3877,202265,1.9167923268978815,98.08320767310212
SC,2001,414459,147167,481022,520792,62114,1625554,3.8210972997513464,96.17890270024866
SD,2001,44372,37035,110286,0,17324,209017,8.288321045656573,91.71167895434343
TN,2001,687352,265461,710393,298424,90783,2052413,4.423232556020645,95.57676744397935
TX,2001,1492977,4382935,5773604,398535,85633,12133684,0.7057460866790334,99.29425391332097
UT,2001,384453,167582,260345,0,7552,819932,0.9210519896771927,99.0789480103228
VA,2001,487601,246406,888633,269003,88665,1980308,4.477333828879144,95.52266617112086
VT,2001,50,7909,89212,43559,11138,151868,7.334000579450575,92.66599942054943
WA,2001,99441,322413,768387,86159,282155,1558555,18.103628040075584,81.89637195992442
WI,2001,494043,363022,603696,120168,113720,1694649,6.710534157810851,93.28946584218914
WV,2001,866590,150543,217958,0,8583,1243674,0.6901326231793863,99.30986737682062
WY,2001,499817,103990,156709,0,6046,766562,0.7887163725830396,99.21128362741696
US,2001,21906355,22747645,38087631,8028853,3516309,94286793,3.72937596891221,96.27062403108779
AK,2002,16429,420808,277400,0,8526,723163,1.1789873099149155,98.82101269008508
AL,2002,845999,389965,562366,332650,193946,2324926,8.342028950598857,91.65797104940114
AR,2002,255242,247899,356282,152024,85421,1096868,7.787719215074193,92.21228078492581
AZ,2002,406479,255247,526176,322260,37807,1547969,2.442361571840263,97.55763842815973
CA,2002,70010,2318656,3704382,358707,355371,6807126,5.220573263958975,94.77942673604103
CO,2002,390480,457708,434502,0,17922,1300612,1.3779666803012736,98.62203331969873
CT,2002,34206,181665,382283,155777,26350,780281,3.376988546433913,96.6230114535661
DC,2002,99,33688,33375,0,880,68042,1.2933188324858176,98.70668116751418
DE,2002,40536,53782,134057,0,1314,229689,0.5720778966341444,99.42792210336586
FL,2002,719670,708638,1892395,351940,173192,3845835,4.503365328985773,95.49663467101422
GA,2002,807121,393127,1006589,324827,265403,2797067,9.488617898677436,90.51138210132257
HI,2002,16618,140,257441,0,9306,283505,3.282481790444613,96.7175182095554
IA,2002,441534,194041,396593,47761,72597,1152526,6.298946835038863,93.70105316496114
ID,2002,10194,73482,160021,0,53899,297596,18.111466551969784,81.88853344803022
IL,2002,986832,1051213,1196049,948761,110651,4293506,2.577171197617984,97.42282880238201
IN,2002,1547530,538368,852562,0,52541,2991001,1.7566359890886027,98.24336401091139
KS,2002,391664,307432,361909,94413,16310,1171728,1.3919612742889134,98.60803872571108
KY,2002,950941,236124,683158,0,37852,1908075,1.9837794635955086,98.01622053640449
LA,2002,232109,1475464,1986027,180702,138090,4012392,3.441587960498376,96.55841203950162
MA,2002,118358,404456,711365,60237,40887,1335303,3.0620016580506446,96.93799834194935
MD,2002,325834,203489,544694,126641,29913,1230571,2.4308227643914897,97.5691772356085
ME,2002,8000,126275,230101,0,121681,486057,25.034306675965986,74.965693324034
MI,2002,739866,984715,992007,324615,88202,3129405,2.8184910550088595,97.18150894499114
MN,2002,360822,374171,650633,142897,92437,1620960,5.70260833086566,94.29739166913434
MO,2002,725679,278873,723507,87605,28675,1844339,1.5547575581278712,98.44524244187213
MS,2002,154339,354550,428283,105041,49672,1091885,4.549197030822843,95.45080296917716
MT,2002,166322,70992,161571,0,44049,442934,9.944822479195546,90.05517752080445
NC,2002,770928,243143,876330,413784,107219,2411404,4.446330851238532,95.55366914876147
ND,2002,422809,61592,123512,0,10973,618886,1.7730244342253663,98.22697556577464
NE,2002,217939,121174,222228,105696,36743,703780,5.220807638750746,94.77919236124926
NH,2002,39845,26077,176568,97054,21186,360730,5.8730906772378235,94.12690932276217
NJ,2002,104849,617094,1178970,322299,28638,2251850,1.2717543353242888,98.72824566467571
NM,2002,284132,229691,243128,0,6408,763359,0.8394477565601506,99.16055224343985
NV,2002,164775,181010,234506,0,19516,599807,3.2537132777710163,96.74628672222899
NY,2002,280584,1227223,1560207,413686,194413,3676113,5.288547985331245,94.71145201466875
OH,2002,1396899,862453,1270998,113451,51814,3695615,1.4020399852257337,98.59796001477427
OK,2002,391379,522530,549321,0,27527,1490757,1.8465115374269583,98.15348846257304
OR,2002,37751,206808,366296,0,168372,779227,21.60756749958613,78.39243250041388
PA,2002,1457349,700472,1403563,794521,81811,4437716,1.8435384328334665,98.15646156716653
RI,2002,76,89824,98079,0,3711,191690,1.9359382336063435,98.06406176639365
SC,2002,404455,190714,478674,556829,71277,1701949,4.18796332910093,95.81203667089908
SD,2002,39957,41532,117665,0,22796,221950,10.2707817075918,89.7292182924082
TN,2002,655906,263690,737577,287927,94468,2039568,4.6317651581119135,95.36823484188808
TX,2002,1550325,4444506,5924903,371923,98089,12389746,0.7916950032712535,99.20830499672874
UT,2002,370551,172366,258213,0,6664,807794,0.8249627999217622,99.17503720007824
VA,2002,482759,266853,855088,285549,76304,1966553,3.880088662751525,96.11991133724848
VT,2002,25,8399,84489,41378,15107,149398,10.111915822166294,89.8880841778337
WA,2002,100832,240494,736282,94484,362353,1534445,23.6145968086181,76.3854031913819
WI,2002,491990,388007,600959,129991,93599,1704546,5.491139576168669,94.50886042383134
WV,2002,993467,155536,228699,0,8968,1386670,0.6467292145932342,99.35327078540676
WY,2002,480360,117387,150160,0,5308,753215,0.7047124658961916,99.2952875341038
US,2002,21902852,23513541,38122145,8145429,3766155,95450122,3.9456785607880103,96.05432143921199
AK,2003,12552,415891,285417,0,8974,722834,1.241502198291724,98.75849780170827
AL,2003,873735,360483,561731,330137,199714,2325800,8.586894831885802,91.4131051681142
AR,2003,253653,254571,357343,153093,90111,1108771,8.127106498997538,91.87289350100247
AZ,2003,406537,275650,537072,297872,36684,1553815,2.3608988200010943,97.6391011799989
CA,2003,69469,2317062,3520087,370958,406651,6684227,6.08374012432552,93.91625987567448
CO,2003,394163,436873,457424,0,19325,1307785,1.4776893755472038,98.5223106244528
CT,2003,41864,157252,434313,167566,29186,830181,3.515618883111032,96.48438111688897
DC,2003,173,33700,29777,0,924,64574,1.4309164679282684,98.56908353207173
DE,2003,46997,47971,136588,0,1400,232956,0.6009718573464516,99.39902814265355
FL,2003,723832,714826,1931768,322868,186771,3880065,4.813604926721588,95.1863950732784
GA,2003,819031,390760,1033435,346601,193921,2783748,6.966183720652875,93.03381627934712
HI,2003,18044,137,269414,0,11492,299087,3.842360249693233,96.15763975030677
IA,2003,444587,197629,375212,41559,81767,1140754,7.1678030495619565,92.83219695043805
ID,2003,10219,71754,140328,0,52787,275088,19.189132204967137,80.81086779503286
IL,2003,1010087,1001534,1238292,987308,125968,4363189,2.8870626507355057,97.1129373492645
IN,2003,1570700,566838,885902,0,54636,3078076,1.7750049056618484,98.22499509433815
KS,2003,389464,284722,419163,92648,19369,1205366,1.6068978219063754,98.39310217809363
KY,2003,943652,231384,644470,0,43994,1863500,2.3608264019318486,97.63917359806815
LA,2003,247978,1353179,1954979,168069,146641,3870846,3.788344976782853,96.21165502321715
MA,2003,109373,414970,730803,51880,43196,1350222,3.1991776167178436,96.80082238328215
MD,2003,329590,204345,570714,142685,36406,1283740,2.8359325096982255,97.16406749030178
ME,2003,7481,73517,265720,0,111054,457772,24.25967512211319,75.7403248778868
MI,2003,747940,950714,968414,291332,103305,3061705,3.3741003787105552,96.62589962128945
MN,2003,390691,374189,671245,139799,95537,1671461,5.715777993025264,94.28422200697473
MO,2003,795634,265133,739036,101089,30291,1931183,1.568520435401513,98.43147956459849
MS,2003,178949,275147,480507,113625,45371,1093599,4.148778482789395,95.8512215172106
MT,2003,188981,70048,157136,0,42039,458204,9.174734397779154,90.82526560222084
NC,2003,771618,227387,900018,426332,140545,2465900,5.699541749462671,94.30045825053733
ND,2003,420832,56088,121722,0,12222,610864,2.0007726760784723,97.99922732392153
NE,2003,227290,119741,229099,83344,38714,698188,5.544924862644446,94.45507513735555
NH,2003,41633,56415,200220,96677,20916,415861,5.029565167207312,94.97043483279269
NJ,2003,106857,635689,1146359,309629,26451,2224985,1.1888170032606962,98.8111829967393
NM,2003,305641,225220,248457,0,6377,785695,0.8116381038443671,99.18836189615563
NV,2003,182553,191050,239284,0,18194,631081,2.882989663767409,97.1170103362326
NY,2003,286179,1131344,1760002,423959,196092,3797576,5.163609628879053,94.83639037112094
OH,2003,1443498,877891,1303901,88327,60200,3773817,1.5952018871079334,98.40479811289207
OK,2003,393790,556306,545461,0,29558,1525115,1.9380833576484395,98.06191664235156
OR,2003,44884,215102,358058,0,160539,778583,20.619381620199775,79.38061837980023
PA,2003,1461986,717461,1446911,774989,87357,4488704,1.9461519405155698,98.05384805948444
RI,2003,101,80339,102986,0,3786,187212,2.0223062624190757,97.97769373758092
SC,2003,419663,151904,495840,525453,79218,1672078,4.73769764329176,95.26230235670823
SD,2003,43017,43868,112417,0,28214,227516,12.400886091527628,87.59911390847238
TN,2003,621425,265806,755961,251718,103624,1998534,5.185000605443791,94.81499939455621
TX,2003,1603971,4177143,5978967,348485,94316,12202882,0.7728993855713757,99.22710061442862
UT,2003,379185,163527,276298,0,6359,825369,0.7704432805205914,99.2295567194794
VA,2003,464353,272055,934350,258633,99007,2028398,4.881044055456572,95.11895594454343
VT,2003,25,8441,87073,46317,16235,158091,10.269401800228982,89.73059819977102
WA,2003,118207,255839,723154,79360,348989,1525549,22.876289126078547,77.12371087392145
WI,2003,488239,397869,579881,127310,105260,1698559,6.197017589615668,93.80298241038433
WV,2003,978415,135367,211544,0,11003,1336329,0.8233750820344391,99.17662491796555
WY,2003,493897,120433,159203,0,5193,778726,0.666858432876262,99.33314156712373
US,2003,22322634,22822564,38713457,7959622,3915884,95734161,4.090372714500522,95.90962728549948
AK,2004,14075,407944,334121,0,8964,765104,1.1716054288044502,98.82839457119555
AL,2004,853917,391927,609981,329898,223107,2408830,9.26204838033402,90.73795161966598
AR,2004,270210,217921,361081,161111,88907,1099230,8.088116226813314,91.91188377318669
AZ,2004,425413,356264,558357,293158,36362,1669554,2.1779469247475673,97.82205307525243
CA,2004,68909,2462247,3670782,315634,423563,6941135,6.102215271709886,93.89778472829012
CO,2004,390186,440720,490984,0,19744,1341634,1.4716383156658224,98.52836168433417
CT,2004,43997,165862,451366,172470,39917,873612,4.5691908993924075,95.43080910060759
DC,2004,741,33097,30534,0,942,65314,1.4422635269620603,98.55773647303793
DE,2004,53599,49722,127465,0,1436,232222,0.6183737974868876,99.38162620251312
FL,2004,699055,757672,2095087,325516,177835,4055165,4.385394922278132,95.61460507772186
GA,2004,834991,406436,1079645,351921,202456,2875449,7.040848229267847,92.95915177073215
HI,2004,17913,155,282864,0,11691,312623,3.73964807451787,96.26035192548213
IA,2004,443221,198017,414787,51399,98090,1205514,8.136778170971054,91.86322182902894
ID,2004,12336,78273,156496,0,56199,303304,18.52893466620948,81.47106533379052
IL,2004,1069538,955972,1285139,959869,124957,4395475,2.842855436556914,97.15714456344308
IN,2004,1614210,526391,865025,0,55136,3060762,1.8013814860482456,98.19861851395176
KS,2004,385498,260117,412120,105664,17104,1180503,1.448873912222163,98.55112608777783
KY,2004,961759,233361,703989,0,46200,1945309,2.3749440320278166,97.62505596797219
LA,2004,256716,1393140,2065896,178110,182508,4076370,4.477218701933338,95.52278129806666
MA,2004,105075,383625,736401,61928,45190,1332219,3.392084934984413,96.60791506501559
MD,2004,327239,201801,590242,152043,36931,1308256,2.822918450211579,97.17708154978843
ME,2004,7336,89581,260353,0,114130,471400,24.21086126431905,75.78913873568095
MI,2004,773825,938628,979694,318700,107956,3118803,3.461456206114974,96.53854379388503
MN,2004,378775,362346,688025,138645,104621,1672412,6.255695366931115,93.74430463306888
MO,2004,807466,268289,744126,81658,34335,1935874,1.7736174978330201,98.22638250216698
MS,2004,184992,290512,480422,106707,61302,1123935,5.454230004404169,94.54576999559583
MT,2004,195620,68567,176136,0,43153,483476,8.925572313827367,91.07442768617263
NC,2004,782692,232214,930984,418065,111793,2475748,4.515524197131533,95.48447580286846
ND,2004,398381,56410,133016,0,12481,600288,2.0791686657071273,97.92083133429287
NE,2004,223624,116006,233553,106796,45845,725824,6.3162695088616525,93.68373049113835
NH,2004,43446,63829,205481,106132,26240,445128,5.894933592135296,94.1050664078647
NJ,2004,112707,644467,1164799,282407,27265,2231645,1.22174449789281,98.77825550210719
NM,2004,309418,229164,255866,0,7420,801868,0.925339332658243,99.07466066734176
NV,2004,193634,221648,260161,0,18741,694184,2.699716501676789,97.30028349832321
NY,2004,276470,1126597,1823746,423797,224085,3874695,5.783293910875566,94.21670608912443
OH,2004,1391290,862397,1303260,166328,61954,3785229,1.6367305650463948,98.36326943495361
OK,2004,372093,555273,526834,0,38703,1492903,2.5924658199494544,97.40753418005055
OR,2004,36460,238049,368456,0,164484,807449,20.370822181958243,79.62917781804175
PA,2004,1474310,723189,1475233,807739,95077,4575548,2.0779368941162897,97.92206310588371
RI,2004,76,74352,98408,0,4500,177336,2.537555826228177,97.46244417377183
SC,2004,433868,169518,569746,533920,81327,1788379,4.547525999802056,95.45247400019794
SD,2004,43562,41757,113059,0,35444,233822,15.158539401767156,84.84146059823284
TN,2004,648005,238761,765424,298369,111134,2061693,5.390424277523375,94.60957572247662
TX,2004,1626029,4039787,6161669,421660,94180,12343325,0.7630034856896338,99.23699651431036
UT,2004,399704,164154,277475,0,6458,847791,0.7617443450095601,99.23825565499044
VA,2004,452557,285607,995785,295272,107570,2136791,5.034184438253437,94.96581556174657
VT,2004,25,8708,95317,40231,14127,158408,8.918110196454725,91.08188980354528
WA,2004,112539,269572,749526,93660,341984,1567281,21.820209649705447,78.17979035029455
WI,2004,499212,385999,606012,123966,94920,1710109,5.550523387690492,94.44947661230951
WV,2004,937062,129358,230361,0,11011,1307792,0.8419534604891298,99.15804653951086
WY,2004,500526,111878,153076,0,6049,771529,0.7840275608564292,99.21597243914357
US,2004,22464302,22927283,40148362,8222774,4105528,97868249,4.194953973274826,95.80504602672518
AK,2005,13994,434704,333091,0,6220,788009,0.7893310863200801,99.21066891367992
AL,2005,890098,363398,606840,330761,213168,2404265,8.86624394565491,91.13375605434508
AR,2005,247169,216600,358312,142864,92426,1057371,8.74111357319238,91.25888642680762
AZ,2005,428445,329302,573763,269327,49885,1650722,3.022010974591724,96.97798902540828
CA,2005,67422,2304463,3741092,377313,439340,6929630,6.340021040084391,93.6599789599156
CO,2005,386670,478520,489645,0,21106,1375941,1.5339320508655532,98.46606794913444
CT,2005,42023,171150,443947,162406,26052,845578,3.080969467039114,96.91903053296089
DC,2005,939,33753,28656,0,263,63611,0.4134505038436748,99.58654949615632
DE,2005,56716,48639,135389,0,1891,242635,0.7793599439487295,99.22064005605127
FL,2005,672309,805446,2130793,300127,186236,4094911,4.54798651301579,95.45201348698421
GA,2005,901010,427825,1120350,329092,192131,2970408,6.468168682551354,93.53183131744865
HI,2005,16506,195,293847,0,12011,322559,3.7236598575764432,96.27634014242355
IA,2005,429777,210742,428465,47362,107697,1224043,8.798465413388255,91.20153458661174
ID,2005,11286,78118,159726,0,65999,315129,20.943486635631757,79.05651336436824
IL,2005,1047532,972710,1403414,973293,107676,4504625,2.39034325831784,97.60965674168216
IN,2005,1594399,535512,859731,0,60877,3050519,1.9956276292657085,98.00437237073429
KS,2005,379823,258695,341906,92055,20056,1092535,1.835730663090885,98.16426933690911
KY,2005,986263,240853,697645,0,55141,1979902,2.7850368351564874,97.21496316484351
LA,2005,253518,1367497,1975571,163598,146488,3906672,3.74968771373691,96.2503122862631
MA,2005,119333,386339,737337,57138,40131,1340278,2.994229555360903,97.0057704446391
MD,2005,329304,211830,603981,153443,37447,1336005,2.802908671748983,97.19709132825102
ME,2005,7059,64818,263938,0,133157,468972,28.393379562106052,71.60662043789395
MI,2005,799463,927535,978894,343048,121209,3170149,3.8234480461328473,96.17655195386715
MN,2005,379114,372082,700917,133948,108275,1694336,6.390408986175115,93.60959101382488
MO,2005,835663,273386,741961,83807,46956,1981773,2.3693934673648296,97.63060653263517
MS,2005,176286,310713,455899,105172,62966,1111036,5.667323111042307,94.33267688895769
MT,2005,199495,71089,182921,0,51745,505250,10.241464621474517,89.75853537852548
NC,2005,811939,237525,947056,417249,112140,2525909,4.439589866459956,95.56041013354005
ND,2005,431133,49643,136531,0,12453,629760,1.9774199695121952,98.0225800304878
NE,2005,228667,120125,228762,91856,45291,714701,6.337055635853315,93.66294436414668
NH,2005,44169,72934,190420,98682,30647,436852,7.015419409777224,92.98458059022278
NJ,2005,125332,625429,1225835,327604,29087,2333287,1.2466104684078727,98.75338953159213
NM,2005,317916,225352,254624,0,17320,815212,2.1246007173594106,97.87539928264059
NV,2005,197799,236007,275627,0,18601,728034,2.554963092383048,97.44503690761695
NY,2005,256879,1107206,1807239,442937,203326,3817587,5.326034481990849,94.67396551800915
OH,2005,1481045,860874,1280172,154481,70162,3846734,1.8239368773614189,98.17606312263858
OK,2005,397379,600011,557797,0,42309,1597496,2.648457335730418,97.35154266426959
OR,2005,35624,239539,374572,0,159664,809399,19.72624132226504,80.27375867773496
PA,2005,1490836,719117,1498536,796157,92768,4597414,2.0178300235741222,97.98216997642588
RI,2005,76,82460,97180,0,1884,181600,1.0374449339207048,98.96255506607929
SC,2005,431086,178308,547413,554544,86267,1797618,4.798961737143264,95.20103826285674
SD,2005,36952,42848,118214,0,40183,238197,16.86964991162777,83.13035008837223
TN,2005,657711,238400,782703,290153,112717,2081684,5.414702711842912,94.5852972881571
TX,2005,1627863,3621139,5987815,398994,103509,11739320,0.88172909504128,99.11827090495872
UT,2005,405546,168770,287599,0,9390,871305,1.0776938041214041,98.92230619587859
VA,2005,458452,311537,998762,291357,122896,2183004,5.62967360572862,94.37032639427137
VT,2005,25,8396,90539,42491,16454,157905,10.420189354358634,89.57981064564137
WA,2005,112284,272167,768653,86016,337270,1576390,21.395086241348906,78.6049137586511
WI,2005,522521,415583,596603,103535,132991,1771233,7.508385401581836,92.49161459841817
WV,2005,959657,124984,231304,0,18247,1334192,1.3676442371113002,98.6323557628887
WY,2005,490940,112863,155289,0,9238,768330,1.2023479494488045,98.79765205055119
US,2005,22793450,22567132,40227276,8160810,4231361,97980029,4.318595374165485,95.68140462583452
AK,2006,14981,375719,342272,0,5330,738302,0.7219267996023307,99.27807320039767
AL,2006,886678,402044,611265,332992,219762,2452741,8.959853486364846,91.04014651363515
AR,2006,256907,240885,358679,158952,90520,1105943,8.184870287166698,91.8151297128333
AZ,2006,431985,365230,582623,250568,51225,1681631,3.0461498390550603,96.95385016094494
CA,2006,67017,2375929,3786528,333488,464148,7027110,6.605105085874563,93.39489491412543
CO,2006,394348,458911,506709,0,24922,1384890,1.799565308436049,98.20043469156396
CT,2006,45722,175870,391609,173111,32250,818562,3.9398359562256737,96.06016404377432
DC,2006,0,29775,22535,0,618,52928,1.1676239419588876,98.8323760580411
DE,2006,56625,44787,122657,0,3638,227707,1.5976671775571238,98.40233282244287
FL,2006,696215,917468,2018975,327934,191666,4152258,4.6159463116212915,95.38405368837871
GA,2006,892732,433920,1089023,333981,194871,2944527,6.618074821524815,93.38192517847519
HI,2006,16102,179,295474,0,12753,324508,3.9299493386911877,96.07005066130881
IA,2006,435187,207162,435701,53171,121844,1253065,9.723677542665385,90.27632245733462
ID,2006,8212,79041,165353,0,73412,326018,22.517775092172826,77.48222490782717
IL,2006,1045398,896138,1340467,982498,105735,4370236,2.4194345568523072,97.58056544314769
IN,2006,1587100,499753,860450,0,52230,2999533,1.7412710578613404,98.25872894213866
KS,2006,364212,269274,351672,97570,21760,1104488,1.9701436321625947,98.02985636783741
KY,2006,1023263,217166,699444,0,52969,1992842,2.657962849036702,97.3420371509633
LA,2006,265214,1346690,2127341,174634,145995,4059874,3.5960475620671972,96.4039524379328
MA,2006,112173,378026,648398,60832,52538,1251967,4.196436487543202,95.8035635124568
MD,2006,324657,189179,538678,144320,46032,1242866,3.7036977437632053,96.2963022562368
ME,2006,6618,67557,235253,0,125205,434633,28.807062510209764,71.19293748979024
MI,2006,773595,816993,926618,303305,119949,2940460,4.079259707664787,95.92074029233521
MN,2006,370814,358198,680945,137569,112721,1660247,6.789411455042533,93.21058854495747
MO,2006,829054,257924,736536,105567,42120,1971201,2.1367683965257727,97.86323160347423
MS,2006,190057,315909,469598,108718,63673,1147955,5.54664599222095,94.45335400777905
MT,2006,194307,75135,194283,0,54574,518299,10.529443429371849,89.47055657062815
NC,2006,777871,230169,918121,417016,115472,2458649,4.696563031160609,95.30343696883939
ND,2006,414838,50007,136542,0,13202,614589,2.1481022276675956,97.8518977723324
NE,2006,227444,131424,228780,93943,47616,729207,6.529833092660931,93.47016690733906
NH,2006,44807,64644,167795,98067,26107,401420,6.503661999900354,93.49633800009964
NJ,2006,116093,566724,1175190,339846,47692,2245545,2.123849666784678,97.87615033321532
NM,2006,316221,227661,268257,0,19069,831208,2.294130951578907,97.70586904842109
NV,2006,84225,257595,291217,0,19723,652760,3.021478031742141,96.97852196825787
NY,2006,256345,1120196,1556773,440606,218253,3592173,6.075793120208854,93.92420687979114
OH,2006,1450797,770872,1289366,175798,72797,3759630,1.936280963818248,98.06371903618175
OK,2006,384418,644381,583533,0,39554,1651886,2.394475163540341,97.60552483645967
OR,2006,26895,229731,381213,0,186076,823915,22.584368533161793,77.4156314668382
PA,2006,1499292,684695,1430279,785731,97986,4497983,2.1784430932709173,97.82155690672909
RI,2006,49,78517,90465,0,5395,174426,3.0930021900404756,96.90699780995952
SC,2006,432220,181895,551756,530071,89225,1785167,4.998131827442474,95.00186817255752
SD,2006,39570,40861,116224,0,48363,245018,19.73854982082949,80.26145017917051
TN,2006,677174,230047,785896,257523,100853,2051493,4.916078192808847,95.08392180719115
TX,2006,1610301,3544789,6086196,430593,145807,11817686,1.2338033012554235,98.76619669874458
UT,2006,382757,197894,310505,0,8972,900128,0.9967471292971666,99.00325287070284
VA,2006,433606,283456,958756,287938,125154,2088910,5.991354342695473,94.00864565730453
VT,2006,27,8062,88725,53287,17925,168026,10.667991858402866,89.33200814159713
WA,2006,69150,271034,795563,97341,396641,1629729,24.3378500351899,75.6621499648101
WI,2006,462732,376559,589851,127657,129100,1685899,7.657635481129059,92.34236451887094
WV,2006,958880,126316,236344,0,17677,1339217,1.3199503889212876,98.68004961107872
WY,2006,489325,112929,166896,0,9136,778286,1.1738615367615504,98.82613846323845
US,2006,22444214,22225318,39743329,8214626,4480260,97107747,4.6136998729874765,95.38630012701252
AK,2007,13662,372186,323089,0,5674,714611,0.793998413122664,99.20600158687733
AL,2007,888436,430649,601179,360036,202747,2483047,8.165250194619755,91.83474980538024
AR,2007,275037,229610,359757,162434,100786,1127624,8.937908380807787,91.06209161919222
AZ,2007,438524,401992,571417,280920,54591,1747444,3.124048610427573,96.87595138957242
CA,2007,66495,2467545,3795097,375427,403528,7108092,5.67702275097171,94.32297724902828
CO,2007,388586,512841,513431,0,31006,1445864,2.144461719774474,97.85553828022553
CT,2007,39931,183604,377002,171874,33937,806348,4.20872873746819,95.79127126253181
DC,2007,502,33856,21547,0,743,56648,1.3116085298686626,98.68839147013134
DE,2007,63839,49932,119810,0,4997,238578,2.094493205576373,97.90550679442363
FL,2007,720824,943845,1938437,307215,200137,4110458,4.868970805686374,95.13102919431363
GA,2007,934773,455220,1052558,341364,192418,2976333,6.464935207182799,93.5350647928172
HI,2007,17107,173,303540,0,13227,334047,3.959622448338108,96.04037755166189
IA,2007,465167,264166,420924,47398,152784,1350439,11.313654300564483,88.68634569943552
ID,2007,10261,83904,162468,0,67904,324537,20.923346182407553,79.07665381759244
IL,2007,1091382,968652,1324077,1004100,124354,4512565,2.7557276183279353,97.24427238167206
IN,2007,1572084,543800,834645,0,64448,3014977,2.137595079498119,97.86240492050189
KS,2007,396333,291695,402282,108762,28456,1227528,2.3181548608259854,97.68184513917402
KY,2007,1020709,235876,690076,0,54715,2001376,2.7338690980605342,97.26613090193946
LA,2007,249800,1430621,2130984,179127,146531,4137063,3.5419088372596694,96.45809116274033
MA,2007,120168,418907,647827,53701,54678,1295281,4.221323403956362,95.77867659604364
MD,2007,327979,208439,531469,150551,47863,1266301,3.7797490486069267,96.22025095139307
ME,2007,6583,67227,233431,0,131781,439022,30.016946758932352,69.98305324106765
MI,2007,801178,814887,919768,330581,132229,2998643,4.409627955044999,95.590372044955
MN,2007,366208,395658,678958,137437,131926,1710187,7.714127168549404,92.28587283145059
MO,2007,802879,277919,730638,98302,54207,1963945,2.7601078441606055,97.2398921558394
MS,2007,185063,374990,460954,98164,64626,1183797,5.459213023854597,94.5407869761454
MT,2007,202480,75077,206442,0,55767,539766,10.331699291915385,89.66830070808462
NC,2007,827974,244475,920732,420029,98912,2512122,3.9373883911689003,96.0626116088311
ND,2007,420719,56842,139972,0,19483,637016,3.0584789079081216,96.94152109209188
NE,2007,216872,153490,229195,115815,60391,775763,7.784722911507767,92.21527708849223
NH,2007,44899,64856,165020,112902,30292,417969,7.247427440791063,92.75257255920894
NJ,2007,111799,640236,1241757,335757,52973,2382522,2.2234002456220763,97.77659975437793
NM,2007,296067,239858,277635,0,21446,835006,2.5683647782171626,97.43163522178284
NV,2007,82871,262547,285879,0,20506,651803,3.146042592623845,96.85395740737616
NY,2007,258450,1214349,1562784,445288,222090,3702961,5.997632705286391,94.00236729471361
OH,2007,1463773,835555,1284301,165349,81156,3830134,2.118881480386848,97.88111851961315
OK,2007,373217,677472,563473,0,50665,1664827,3.043259149449162,96.95674085055084
OR,2007,45461,260240,374647,0,177179,857527,20.6616234824093,79.3383765175907
PA,2007,1491907,780090,1402752,811600,103314,4589663,2.251014943798706,97.74898505620129
RI,2007,39,90259,87046,0,6383,183727,3.474176359489895,96.52582364051011
SC,2007,444046,182201,533797,558014,88416,1806474,4.894396487300675,95.10560351269932
SD,2007,33256,54099,117482,0,49617,254454,19.499398712537435,80.50060128746257
TN,2007,672766,229520,773597,301038,94530,2071451,4.563467830037978,95.43653216996202
TX,2007,1609155,3626526,5917140,429577,181554,11763952,1.5433078951699224,98.45669210483008
UT,2007,391386,231125,299418,0,9691,931620,1.0402309954702562,98.95976900452975
VA,2007,458200,331018,958752,286019,128531,2162520,5.943575088322882,94.05642491167711
VT,2007,34,8874,86757,49337,14803,159805,9.263164481712087,90.73683551828792
WA,2007,95737,279429,820408,85051,368316,1648941,22.336517801425277,77.66348219857473
WI,2007,465083,403947,584630,135416,131294,1720370,7.631730383580276,92.36826961641972
WV,2007,983259,124555,235366,0,17881,1361061,1.3137544900632667,98.68624550993674
WY,2007,494955,145985,169430,0,9342,819712,1.1396685665209245,98.86033143347908
US,2007,22747914,23670821,39383775,8458589,4594827,98855926,4.648003600714842,95.35199639928516
AK,2008,14705,343938,278725,0,5363,642731,0.8344081738705618,99.16559182612944
AL,2008,842826,414260,566323,407551,198348,2429308,8.164794254166207,91.83520574583379
AR,2008,278849,238424,354937,148085,96258,1116553,8.620996943270942,91.37900305672906
AZ,2008,458727,409966,542166,305726,64586,1781171,3.6260415198765306,96.37395848012346
CA,2008,63050,2472612,3553537,339506,397934,6826639,5.829134952060596,94.1708650479394
CO,2008,385416,508491,486432,0,43089,1423428,3.027128874800833,96.97287112519916
CT,2008,45188,169802,339919,161305,32903,749117,4.392237794630211,95.6077622053698
DC,2008,391,32774,18444,0,561,52170,1.075330649798735,98.92466935020127
DE,2008,60891,49749,112725,0,5806,229171,2.533479366935607,97.46652063306439
FL,2008,693161,970038,1717483,335857,242263,3958802,6.119603859955613,93.88039614004438
GA,2008,885849,436093,946224,331235,185431,2784832,6.658606336037506,93.34139366396249
HI,2008,18095,148,239055,0,15545,272843,5.697415729925268,94.30258427007473
IA,2008,485218,297357,423828,55210,181598,1443211,12.5829140714698,87.4170859285302
ID,2008,8604,90550,152495,0,70653,322302,21.921365675670643,78.07863432432936
IL,2008,1103163,1003219,1274262,994526,143612,4518782,3.1781130401953446,96.82188695980466
IN,2008,1558078,555489,778521,0,94753,2986841,3.1723483104725028,96.8276516895275
KS,2008,371804,292523,349719,88812,46651,1149509,4.058341430993581,95.94165856900642
KY,2008,1024816,233165,645708,0,58866,1962555,2.9994573400490685,97.00054265995094
LA,2008,262470,1369823,2193330,160658,107782,4094063,2.6326414615505427,97.36735853844945
MA,2008,106897,415247,621929,61339,53250,1258662,4.230683058676595,95.76931694132341
MD,2008,309294,202744,507179,153422,47797,1220436,3.9163872583240744,96.08361274167592
ME,2008,5908,74494,201971,0,157289,439662,35.774981690480416,64.22501830951958
MI,2008,799969,797534,836361,329075,148532,2911471,5.101613582962015,94.89838641703798
MN,2008,359359,435086,643535,135843,146849,1720672,8.53439818861468,91.46560181138531
MO,2008,792918,298421,675205,98025,69586,1934155,3.5977468196706055,96.4022531803294
MS,2008,177166,364237,422379,98215,50484,1112481,4.537965142775472,95.46203485722452
MT,2008,203260,77645,192417,0,57184,530506,10.779142931465431,89.22085706853457
NC,2008,794693,249654,883566,415742,148314,2491969,5.951679174179133,94.04832082582087
ND,2008,424615,60480,137092,0,24181,646368,3.7410577256299815,96.25894227437001
NE,2008,234654,172858,219571,99075,81046,807204,10.040336767409478,89.95966323259053
NH,2008,40241,74025,160994,97729,33082,406071,8.146851166421635,91.85314883357836
NJ,2008,97671,634694,1216492,336500,50295,2335652,2.153360175231584,97.84663982476842
NM,2008,284346,252831,241949,0,24258,803384,3.019477609710923,96.98052239028908
NV,2008,88619,274915,259144,0,23030,645708,3.566627639738086,96.43337236026191
NY,2008,228985,1205137,1480358,451622,247215,3613317,6.841774469275737,93.15822553072427
OH,2008,1438432,823457,1232449,183055,113362,3790755,2.990486064121791,97.0095139358782
OK,2008,391688,711379,540101,0,48097,1691265,2.8438476524968,97.1561523475032
OR,2008,41408,274659,356012,0,184906,856985,21.576340309340303,78.42365969065969
PA,2008,1421091,778251,1380331,822134,125169,4526976,2.764958329798965,97.23504167020103
RI,2008,0,91220,89555,0,6283,187058,3.3588512653829294,96.64114873461708
SC,2008,445454,175858,502602,541026,100151,1765091,5.673985080655898,94.3260149193441
SD,2008,43098,65453,112732,0,61713,282996,21.807022007378198,78.1929779926218
TN,2008,643796,238441,714765,282514,113241,1992757,5.6826296432530405,94.31737035674696
TX,2008,1605925,3653462,5245208,425682,239837,11170114,2.147131175205553,97.85286882479444
UT,2008,395878,237414,279173,0,11704,924169,1.2664350351504974,98.7335649648495
VA,2008,415102,310647,870324,291932,135050,2023055,6.675547624755629,93.32445237524438
VT,2008,0,8665,77454,51163,19163,156445,12.249033206558215,87.75096679344179
WA,2008,94601,307085,766791,96886,374236,1639599,22.82484924667556,77.17515075332444
WI,2008,480712,415109,558483,127039,146254,1727597,8.465747509401787,91.5342524905982
WV,2008,955628,119617,221682,0,23203,1320130,1.7576299303856437,98.24237006961435
WY,2008,500109,147129,169975,0,10883,828096,1.3142196073885153,98.68578039261149
US,2008,22382816,23836273,36791612,8426491,5067648,96504840,5.2511853291503305,94.74881467084967
AK,2009,14505,343971,265425,0,7238,631139,1.14681551924378,98.85318448075623
AL,2009,630969,466272,517075,415392,194840,2224548,8.758633214477728,91.24136678552227
AR,2009,264083,248100,335203,158663,104241,1110290,9.388628196237018,90.61137180376298
AZ,2009,413260,377504,498687,320692,54618,1664761,3.2808313025112916,96.71916869748871
CA,2009,52403,2391374,3409620,332218,419883,6605498,6.356568422244621,93.64343157775538
CO,2009,350224,525999,466469,0,45679,1388371,3.2901148180133406,96.70988518198666
CT,2009,26265,188570,338783,174220,38410,766248,5.012737390505424,94.98726260949458
DC,2009,331,34339,22471,0,616,57757,1.0665373894073447,98.93346261059266
DE,2009,33938,51651,85881,0,6644,178114,3.7301952681990187,96.26980473180099
FL,2009,581517,1081725,1576747,304544,272575,3817108,7.140877334358891,92.85912266564111
GA,2009,723449,475240,992083,331368,200811,2722951,7.374756284633841,92.62524371536615
HI,2009,17083,167,238955,0,16028,272233,5.887603633652056,94.11239636634795
IA,2009,444574,283990,416441,48937,236140,1430082,16.512339851840665,83.48766014815934
ID,2009,8443,87072,144870,0,67560,307945,21.938982610531102,78.0610173894689
IL,2009,1014972,956553,1189030,998562,166255,4325372,3.8437156387936113,96.15628436120639
IN,2009,1365413,511289,747708,0,106357,2730767,3.8947665619219802,96.10523343807802
KS,2009,356079,292425,346677,91710,48231,1135122,4.248970595231174,95.75102940476883
KY,2009,937106,214261,640148,0,63701,1855216,3.4336163551845176,96.56638364481549
LA,2009,252519,1315265,2042813,175524,111298,3897419,2.855684749317433,97.14431525068257
MA,2009,92056,408509,571114,56437,61522,1189638,5.171489142075152,94.82851085792485
MD,2009,266860,203604,508205,152180,55017,1185866,4.639394332917885,95.36060566708211
ME,2009,1652,73569,202727,0,124976,402924,31.01726380161023,68.98273619838977
MI,2009,735907,750783,803722,228540,138933,2657885,5.2272013273711995,94.7727986726288
MN,2009,328678,405516,590884,129623,166637,1621338,10.277745911093184,89.72225408890682
MO,2009,765617,266711,644534,107175,77206,1861243,4.1480881325007,95.8519118674993
MS,2009,141675,371245,399440,115033,56883,1084276,5.2461734835042,94.7538265164958
MT,2009,172812,76635,182771,0,50888,483106,10.533506104250414,89.4664938957496
NC,2009,678673,252729,798958,427226,147739,2305325,6.408597486254649,93.59140251374535
ND,2009,423267,51921,127584,0,35499,638271,5.561744149428691,94.43825585057131
NE,2009,249593,165418,215962,98682,81620,811275,10.06070691195957,89.93929308804043
NH,2009,32844,62049,154101,92214,38878,380086,10.228737706729529,89.77126229327047
NJ,2009,59563,638324,1029990,359036,65510,2152423,3.043546737792711,96.95645326220729
NM,2009,306162,247947,226328,0,21877,802314,2.726737910593608,97.27326208940639
NV,2009,83812,284007,237601,0,26855,632275,4.247360721205172,95.75263927879483
NY,2009,155965,1166614,1385817,454806,218597,3381799,6.463926448615071,93.53607355138493
OH,2009,1267267,770759,1124733,159040,110872,3432671,3.2299046427694353,96.77009535723056
OK,2009,373271,681062,504573,0,52787,1611693,3.275251552249715,96.72474844775029
OR,2009,33150,254837,347642,0,191659,827288,23.16714372745646,76.83285627254354
PA,2009,1223937,839453,1246017,808770,140965,4259142,3.309704161072817,96.69029583892718
RI,2009,0,94877,91578,0,7401,193856,3.817782271376692,96.18221772862331
SC,2009,371981,197419,512765,545434,107607,1735206,6.201396260732155,93.79860373926785
SD,2009,37480,66317,115125,0,75216,294138,25.571670440405523,74.42832955959447
TN,2009,477713,223019,655561,281996,127155,1765444,7.202437460491525,92.79756253950848
TX,2009,1497854,3481133,5058649,434024,219248,10690908,2.0507893249104754,97.94921067508953
UT,2009,364994,223646,264872,0,12283,865795,1.4186961116661565,98.58130388833385
VA,2009,334605,330369,810761,295072,136235,1907042,7.143786030931674,92.85621396906832
VT,2009,0,8679,84441,56067,24709,173896,14.209067488613885,85.79093251138612
WA,2009,84048,319739,732609,69385,367957,1573738,23.381083763625202,76.6189162363748
WI,2009,425941,392485,518633,132653,137931,1607643,8.579703329657145,91.42029667034285
WV,2009,742922,118643,191481,0,35932,1088978,3.299607521915043,96.70039247808495
WY,2009,473912,147220,163896,0,14755,799783,1.844875422458342,98.15512457754166
US,2009,19691342,23421003,34778160,8355220,5292473,91538198,5.781709838771351,94.21829016122865
AK,2010,14548,334978,272000,0,7793,629319,1.2383226948495119,98.76167730515049
AL,2010,718684,544405,521208,396557,210935,2391789,8.819130784529905,91.1808692154701
AR,2010,293689,274774,342590,157017,115374,1183444,9.749003755141773,90.25099624485823
AZ,2010,457909,336208,550462,326102,56740,1727421,3.2846654058275315,96.71533459417248
CA,2010,54972,2325411,3252176,336562,492958,6462079,7.628473746606936,92.37152625339307
CO,2010,382623,505628,483446,0,49454,1421151,3.4798554129715984,96.5201445870284
CT,2010,28711,203814,332096,175074,40968,780663,5.247847022338704,94.7521529776613
DC,2010,71,33717,24155,0,1078,59021,1.826468545094119,98.17353145490588
DE,2010,30253,56086,100950,0,7710,194999,3.9538664300842568,96.04613356991574
FL,2010,637416,1180462,1716327,250178,288862,4073245,7.091692250282024,92.90830774971798
GA,2010,767906,540943,1052665,350268,226919,2938701,7.721745083967372,92.27825491603262
HI,2010,17117,161,262136,0,14385,293799,4.8962045480073115,95.1037954519927
IA,2010,493794,278751,417393,46518,270864,1507320,17.969906854549798,82.03009314545021
ID,2010,8527,85075,161433,0,70911,325946,21.75544415332601,78.24455584667399
IL,2010,1069037,962240,1200027,1005374,186339,4423017,4.212938815292819,95.78706118470718
IN,2010,1449371,577423,720773,0,126618,2874185,4.4053531696811445,95.59464683031885
KS,2010,359908,280413,348058,99876,53424,1141679,4.679423901114061,95.32057609888594
KY,2010,1009823,239057,643976,0,67917,1960773,3.4637869860509096,96.5362130139491
LA,2010,259750,1482948,1959825,194818,127337,4024678,3.1639052863359503,96.83609471366405
MA,2010,83850,447428,588177,61853,68744,1250052,5.499291229484854,94.50070877051515
MD,2010,266067,217625,498490,146265,61545,1189992,5.171883508460561,94.82811649153943
ME,2010,2279,80988,189886,0,136657,409810,33.34642883287377,66.65357116712623
MI,2010,749285,758696,819109,309636,149827,2786553,5.376786301929301,94.6232136980707
MN,2010,315438,427186,587524,140873,189237,1660258,11.398047773297884,88.60195222670211
MO,2010,801625,282123,646145,94027,84991,1908911,4.452329102823547,95.54767089717646
MS,2010,148463,444875,379355,100791,74801,1148285,6.5141493618744475,93.48585063812556
MT,2010,203339,72888,171928,0,51579,499734,10.321290926773043,89.67870907322695
NC,2010,749091,308710,875741,425810,160129,2519481,6.355634354853241,93.64436564514676
ND,2010,409684,64263,148124,0,44774,666845,6.7143039237004105,93.28569607629959
NE,2010,254552,169608,243507,115540,122553,905760,13.530405405405405,86.4695945945946
NH,2010,33827,62612,148229,114032,41375,400075,10.34181091045429,89.65818908954571
NJ,2010,71961,671005,920302,342526,72326,2078120,3.4803572459723213,96.51964275402769
NM,2010,267474,246201,225542,0,26939,766156,3.51612465346483,96.48387534653517
NV,2010,80228,267808,282871,0,27939,658846,4.240596436800102,95.7594035631999
NY,2010,167094,1224484,1486212,437620,226403,3541813,6.392291179686787,93.6077088203132
OH,2010,1355137,810593,1091489,165192,126008,3548419,3.5511026178137364,96.44889738218626
OK,2010,346047,697351,522797,0,66293,1632488,4.060856802622745,95.93914319737725
OR,2010,42556,242914,341546,0,188057,815073,23.072411918932413,76.92758808106758
PA,2010,1310670,909259,1238970,813462,163129,4435490,3.6778123724774487,96.32218762752255
RI,2010,0,95710,88835,0,7142,191687,3.725865603822899,96.2741343961771
SC,2010,404966,225961,506158,543379,119773,1800237,6.653179553581,93.346820446419
SD,2010,39061,72926,114466,0,86937,313390,27.74083410447047,72.25916589552953
TN,2010,515464,263365,681491,289930,124946,1875196,6.663090151642815,93.33690984835718
TX,2010,1568060,3689581,5385557,432036,283455,11358689,2.495490456689148,97.50450954331085
UT,2010,356148,229078,259192,0,13751,858169,1.60236503532521,98.3976349646748
VA,2010,346161,385768,844761,277729,134830,1989249,6.777934788455342,93.22206521154466
VT,2010,0,8501,81482,49986,26194,166163,15.764038925633264,84.23596107436674
WA,2010,94934,294871,691829,96588,376381,1554603,24.21074705246291,75.7892529475371
WI,2010,458442,376627,528641,138812,165741,1668263,9.934944310339556,90.06505568966044
WV,2010,848129,121780,203781,0,37740,1211430,3.1153265149451475,96.88467348505485
WY,2010,484239,154759,166320,0,18850,824168,2.2871550460585706,97.71284495394143
US,2010,20828382,24568039,35320151,8434433,5895636,95046641,6.202887275101074,93.79711272489892
AK,2011,15481,339819,268942,0,7523,631765,1.1907908795200748,98.80920912047992
AL,2011,651032,609288,521480,411822,224020,2417642,9.26605345208265,90.73394654791736
AR,2011,306119,288906,337959,148531,116386,1197901,9.715827935697524,90.28417206430248
AZ,2011,459909,293134,554787,327292,66102,1701224,3.8855553413307127,96.11444465866929
CA,2011,55264,2196252,3181918,383644,541230,6358308,8.512170218869548,91.48782978113046
CO,2011,368871,477208,464795,0,60210,1371084,4.391415843230612,95.60858415676938
CT,2011,6081,236016,317514,166669,39940,766220,5.212602124716139,94.78739787528386
DC,2011,48,33389,22246,0,1200,56883,2.1095933758767997,97.8904066241232
DE,2011,17881,81710,114744,0,7705,222040,3.4700954782921998,96.5299045217078
FL,2011,552730,1235953,1611343,230369,289556,3919951,7.386724987123563,92.61327501287644
GA,2011,634756,531596,1016569,338052,232231,2753204,8.434936168914472,91.56506383108552
HI,2011,16080,158,266086,0,15364,297688,5.161108274434979,94.83889172556502
IA,2011,463138,277576,415736,54572,280133,1491155,18.786309940951814,81.21369005904819
ID,2011,7846,83947,158704,0,84605,335102,25.247536570954516,74.75246342904549
IL,2011,1052224,986310,1170089,1002694,190559,4401876,4.329040618136449,95.67095938186355
IN,2011,1333442,635117,711934,0,132120,2812613,4.6974112684539255,95.30258873154608
KS,2011,346521,285318,328557,76585,57429,1094410,5.247484946226734,94.75251505377327
KY,2011,1010623,229048,630863,0,70949,1941483,3.654371426378701,96.3456285736213
LA,2011,269993,1535704,1948276,173859,128235,4056067,3.1615602010519055,96.83843979894809
MA,2011,42963,464018,574630,53212,69777,1204600,5.792545243234269,94.20745475676573
MD,2011,241190,199132,480971,150655,63326,1135274,5.57803666780002,94.42196333219998
ME,2011,1542,75061,188464,0,137486,402553,34.153515189304265,65.84648481069573
MI,2011,691150,787337,801053,344155,164573,2788268,5.902337938820802,94.0976620611792
MN,2011,315604,424958,575522,125134,194486,1635704,11.890048566244259,88.10995143375574
MO,2011,825650,275308,624140,98062,81011,1904171,4.2543973204087235,95.74560267959127
MS,2011,107546,437873,369149,108164,75706,1098438,6.892150490059521,93.10784950994048
MT,2011,165687,79470,178538,0,56107,479802,11.69378201841593,88.30621798158407
NC,2011,624783,311189,831364,424073,165810,2357219,7.034136412441949,92.96586358755805
ND,2011,394771,72247,184715,0,52447,704180,7.447953648214945,92.55204635178505
NE,2011,285384,173657,231691,72549,127277,890558,14.291826023684028,85.70817397631598
NH,2011,24489,72778,147679,87508,41590,374044,11.119012736469505,88.8809872635305
NJ,2011,49592,677521,932271,351658,72030,2083072,3.457873755683913,96.54212624431608
NM,2011,284737,251838,232017,0,28302,796894,3.551538849583508,96.44846115041649
NV,2011,62701,255970,267974,0,28210,614855,4.588073610851339,95.41192638914866
NY,2011,125181,1247757,1388094,446761,240517,3448310,6.974923948252912,93.02507605174709
OH,2011,1222606,848771,1067933,155806,133265,3428381,3.887111729997337,96.11288827000266
OK,2011,378320,676910,506705,0,69595,1631530,4.265627968839065,95.73437203116093
OR,2011,35135,203607,329389,0,230894,799025,28.89696817996934,71.10303182003067
PA,2011,1212984,1000507,1209704,796798,179960,4399953,4.090043689103043,95.90995631089696
RI,2011,0,102465,82332,0,6878,191675,3.588365723229425,96.41163427677057
SC,2011,366160,235465,485405,553573,127571,1768174,7.2148442404424,92.7851557595576
SD,2011,32112,73973,112792,0,95601,314478,30.39990078797245,69.60009921202754
TN,2011,481127,267929,673742,281682,130247,1834727,7.098985298630259,92.90101470136975
TX,2011,1695239,3800578,5384725,414881,328340,11623763,2.82473068317033,97.17526931682967
UT,2011,346181,230672,278040,0,17824,872717,2.0423573735815848,97.95764262641842
VA,2011,288348,383436,796047,267334,130418,1865583,6.990736943893678,93.00926305610632
VT,2011,0,8677,79951,51351,23862,163841,14.564120092040454,85.43587990795955
WA,2011,56951,272261,694968,50293,461167,1535640,30.030931728790602,69.9690682712094
WI,2011,447370,399247,516658,120962,164772,1649009,9.99218318396079,90.00781681603921
WV,2011,822645,124935,199480,0,37949,1185009,3.2024229351844586,96.79757706481554
WY,2011,467671,161776,168738,0,24985,823170,3.035217512785937,96.96478248721407
US,2011,19663856,24953771,34637421,8268698,6307483,93831229,6.722157502594365,93.27784249740563
AK,2012,15521,347228,250011,0,7954,620714,1.2814275173429308,98.71857248265707
AL,2012,547004,677380,514233,427975,220139,2386731,9.223452496322375,90.77654750367762
AR,2012,296732,300572,321281,162353,111545,1192483,9.35401175530385,90.64598824469616
AZ,2012,420570,339043,540351,334636,60959,1695559,3.595215501200489,96.40478449879951
CA,2012,43832,2456371,3086305,193939,495642,6276089,7.897306746287377,92.10269325371262
CO,2012,370085,456471,459554,0,60542,1346652,4.495742032834021,95.50425796716598
CT,2012,9290,236260,300712,178959,37244,762465,4.884683231361439,95.11531676863856
DC,2012,77,29389,19379,0,964,49809,1.9353932020317612,98.06460679796824
DE,2012,17384,104421,109034,0,6856,237695,2.8843686236563664,97.11563137634363
FL,2012,482984,1348390,1550904,187259,288154,3857691,7.469597746423962,92.53040225357604
GA,2012,435546,624338,956582,355674,226583,2598723,8.719013146072129,91.28098685392787
HI,2012,16572,187,258667,0,15252,290678,5.247043119878353,94.75295688012164
IA,2012,422595,266283,390948,45552,280227,1405605,19.936397494317394,80.06360250568261
ID,2012,5186,90339,154544,0,77803,327872,23.729687195002928,76.27031280499708
IL,2012,969294,939024,1128635,1010189,191114,4238256,4.509260412773556,95.49073958722644
IN,2012,1193465,654528,684732,0,121989,2654714,4.595184264670318,95.40481573532968
KS,2012,307585,268086,329353,86818,57859,1049701,5.511950545917362,94.48804945408264
KY,2012,909705,232701,619396,0,65400,1827202,3.579243017466049,96.42075698253394
LA,2012,238811,1585876,1804806,164092,125780,3919365,3.20919332595969,96.79080667404031
MA,2012,24036,430920,537309,61402,66453,1120120,5.932667928436239,94.06733207156375
MD,2012,192334,216558,470496,142297,59562,1081247,5.508639561543292,94.49136043845671
ME,2012,1299,70451,170161,0,134696,376607,35.76566553462894,64.23433446537106
MI,2012,621633,804084,783366,293619,164813,2667515,6.178521957702206,93.8214780422978
MN,2012,257875,430277,580459,125159,193188,1586958,12.17347907127977,87.82652092872023
MO,2012,768297,258945,600129,112317,72318,1812006,3.9910463872636184,96.00895361273638
MS,2012,82456,499946,373544,76456,88312,1120714,7.879976514971705,92.1200234850283
MT,2012,157308,75234,174021,0,51203,457766,11.185409139167172,88.81459086083282
NC,2012,534713,367948,803449,412722,164772,2283604,7.215436651888856,92.78456334811115
ND,2012,406344,71873,199063,0,51186,728466,7.02654619433165,92.97345380566836
NE,2012,272587,161770,233303,60795,116977,845432,13.836358216864278,86.16364178313572
NH,2012,14191,74336,138308,85814,41482,354131,11.71374434884266,88.28625565115733
NJ,2012,25589,670827,885409,346962,70938,1999725,3.5473877658178,96.4526122341822
NM,2012,263439,249815,232882,0,28068,774204,3.625401057085729,96.37459894291428
NV,2012,52850,281432,262465,0,30425,627172,4.851141313706607,95.1488586862934
NY,2012,72914,1260950,1342304,427277,226194,3329639,6.793349068772921,93.20665093122707
OH,2012,1019140,869556,1045652,179055,133625,3247028,4.115301746704987,95.88469825329501
OK,2012,327089,712411,521974,0,78407,1639881,4.781261567150299,95.2187384328497
OR,2012,28259,220578,321335,0,229671,799843,28.71451022263119,71.28548977736881
PA,2012,1093178,1079495,1159310,787753,173137,4292873,4.033126533209811,95.96687346679019
RI,2012,0,98435,78918,0,5989,183342,3.2665728529196802,96.73342714708032
SC,2012,298572,250481,468505,535952,131684,1685194,7.8141745104717915,92.18582548952821
SD,2012,35574,71501,116864,0,89696,313635,28.598848980502815,71.40115101949719
TN,2012,423086,281007,647161,263045,129841,1744140,7.444413865859392,92.55558613414061
TX,2012,1498818,3964124,5495307,402823,329437,11690509,2.817986795955591,97.18201320404441
UT,2012,322055,232630,270540,0,17067,842292,2.026256927526321,97.97374307247368
VA,2012,222270,424000,796654,300992,130158,1874074,6.945189997833597,93.0548100021664
VT,2012,0,8287,75402,52283,21145,157117,13.458123563968252,86.54187643603174
WA,2012,42656,271947,698004,97808,450039,1560454,28.840260590828056,71.15973940917195
WI,2012,373281,410305,502079,149845,158804,1594314,9.960647651591845,90.03935234840816
WV,2012,756716,140133,194307,0,35379,1126535,3.1405149418349185,96.85948505816508
WY,2012,490128,158546,172649,0,23297,844620,2.758281830882527,97.24171816911748
US,2012,17380923,26075691,33830753,8061822,6149965,91499154,6.721335368849421,93.27866463115058
AK,2013,14819,332631,231297,0,8940,587687,1.521217927229971,98.47878207277003
AL,2013,565051,625869,492852,426488,257048,2367308,10.858240668303406,89.14175933169659
AR,2013,327099,288045,321573,124816,115098,1176631,9.781996224814746,90.21800377518525
AZ,2013,454865,340375,547104,328423,62325,1733092,3.5961737749640528,96.40382622503594
CA,2013,38151,2480792,3074636,187162,554027,6334768,8.745813579913266,91.25418642008674
CO,2013,363532,480875,466797,0,68191,1379395,4.9435440899814775,95.05645591001853
CT,2013,7679,240102,307980,178465,39857,774083,5.148931057780626,94.85106894221937
DC,2013,4,33725,18824,0,1033,53586,1.9277423207554212,98.07225767924457
DE,2013,18254,100682,101469,0,7061,227466,3.1042001881599885,96.89579981184
FL,2013,505155,1245287,1590534,277169,302082,3920227,7.705727244876381,92.29427275512361
GA,2013,426184,634635,976637,343801,263562,2644819,9.965218791909768,90.03478120809024
HI,2013,15306,197,259890,0,18072,293465,6.158144923585436,93.84185507641456
IA,2013,402402,306419,414922,55597,289684,1469024,19.719487224170607,80.2805127758294
ID,2013,7965,107089,158820,0,73262,347136,21.104696718289084,78.89530328171091
IL,2013,1026925,1063511,1160515,1014926,205035,4470912,4.585977089238169,95.41402291076183
IN,2013,1198611,680051,723093,0,133882,2735637,4.8939972664501905,95.10600273354981
KS,2013,326817,288274,339091,74902,74687,1103771,6.766530376319001,93.233469623681
KY,2013,914774,235703,583467,0,75844,1809788,4.190767095372497,95.8092329046275
LA,2013,228055,1504969,1761739,177156,143622,3815541,3.7641320064441715,96.23586799355583
MA,2013,42208,435312,565544,45251,72745,1161060,6.265395414534994,93.73460458546501
MD,2013,183191,206126,478979,149048,65478,1082822,6.046977250185164,93.95302274981483
ME,2013,1657,65886,182528,0,140106,390177,35.90831853235839,64.0916814676416
MI,2013,658172,831741,836656,302194,182543,2811306,6.493174346727108,93.5068256532729
MN,2013,267695,478611,597971,111885,191780,1647942,11.637545496140033,88.36245450385996
MO,2013,806549,281399,602535,87428,83153,1861064,4.4680354893759695,95.53196451062404
MS,2013,97767,426902,364975,113523,76269,1079436,7.065634275677298,92.9343657243227
MT,2013,166104,82298,173995,0,48259,470656,10.25356098721784,89.74643901278216
NC,2013,493771,445018,813792,420486,185881,2358948,7.87982609196981,92.1201739080302
ND,2013,393193,82334,222218,0,51321,749066,6.851332192356882,93.14866780764312
NE,2013,292956,179617,232088,71736,119961,896358,13.383157176039038,86.61684282396097
NH,2013,16778,55649,144599,114173,47801,379000,12.612401055408972,87.38759894459103
NJ,2013,25910,711999,879172,348784,77873,2043738,3.810322066722838,96.18967793327717
NM,2013,256377,252867,233179,0,29528,771951,3.8251132520069278,96.17488674799307
NV,2013,64838,282245,269976,0,34566,651625,5.304584692115864,94.69541530788413
NY,2013,68707,1315282,1329816,467651,242438,3423894,7.080768271447655,92.91923172855235
OH,2013,1104486,945731,1055182,168451,148389,3422239,4.3360209500271605,95.66397904997284
OK,2013,335925,682277,505493,0,96029,1619724,5.928726128649078,94.07127387135093
OR,2013,38900,244265,321437,0,223251,827853,26.96746886222554,73.03253113777446
PA,2013,1126118,1175535,1184191,822483,197360,4505687,4.380242125118767,95.61975787488123
RI,2013,0,88274,82269,0,5902,176445,3.3449516846609426,96.65504831533906
SC,2013,257319,236942,480737,566879,139122,1680999,8.276150075044661,91.72384992495535
SD,2013,34246,84527,112852,0,87325,318950,27.37889951403041,72.62110048596959
TN,2013,399768,284750,656717,297732,149508,1788475,8.359524175624484,91.64047582437551
TX,2013,1597357,4131225,5820393,400353,354056,12303384,2.877712343205739,97.12228765679426
UT,2013,355230,258661,273995,0,16521,904407,1.826721818827143,98.17327818117286
VA,2013,290508,433438,794789,306430,147080,1972245,7.457491336015556,92.54250866398445
VT,2013,0,9743,78707,50639,26571,165660,16.039478449837016,83.96052155016298
WA,2013,74955,327840,700446,88408,420370,1612019,26.077236062354103,73.9227639376459
WI,2013,454554,454050,511039,121994,166500,1708137,9.74746170828218,90.25253829171781
WV,2013,771188,152880,195189,0,42253,1161510,3.637764633967852,96.36223536603215
WY,2013,520699,156110,163198,0,23248,863255,2.6930628840840773,97.30693711591593
US,2013,18038771,26788768,34395898,8244433,6586497,94054367,7.0028614407664875,92.9971385592335
AK,2014,18225,329274,226704,0,11523,585726,1.9673021173722867,98.03269788262772
AL,2014,575912,650570,491062,431368,236143,2385055,9.900945680497934,90.09905431950206
AR,2014,339214,273009,325740,151428,115127,1204518,9.557931056239923,90.44206894376008
AZ,2014,447849,315916,547040,338044,72405,1721254,4.206526172197711,95.79347382780229
CA,2014,39486,2409574,3063217,177656,560635,6250568,8.969344865938584,91.03065513406142
CO,2014,350526,497182,482880,0,71727,1402315,5.11489929152865,94.88510070847136
CT,2014,9097,242227,308896,165677,41797,767694,5.44448699612085,94.55551300387916
DC,2014,48,35302,20156,0,1149,56655,2.0280646015356103,97.9719353984644
DE,2014,10238,107051,103155,0,7367,227811,3.2338210183002576,96.76617898169974
FL,2014,557882,1241250,1615826,291474,297773,4004205,7.436507371625579,92.56349262837442
GA,2014,482657,664808,949713,340652,279757,2717587,10.294316244521335,89.70568375547866
HI,2014,17241,167,249595,0,18386,285389,6.44243471191952,93.55756528808048
IA,2014,401151,311352,423401,43431,301848,1481183,20.37884582796319,79.62115417203681
ID,2014,7472,93610,163657,0,83266,348005,23.926667720291377,76.07333227970862
IL,2014,1017855,1108134,1187523,1023496,211286,4548294,4.645390117701274,95.35460988229873
IN,2014,1221492,723942,736761,0,138401,2820596,4.906799839466553,95.09320016053344
KS,2014,316572,291483,356753,89512,85170,1139490,7.474396440512861,92.52560355948714
KY,2014,913452,262278,580917,0,77063,1833710,4.202572925926128,95.79742707407387
LA,2014,209973,1547176,1698078,181059,165771,3802057,4.3600345812806065,95.6399654187194
MA,2014,29871,432523,564859,60340,74511,1162104,6.411732512752732,93.58826748724726
MD,2014,201220,217227,485480,150017,64310,1118254,5.750929574139685,94.24907042586031
ME,2014,2142,62423,185984,0,135221,385770,35.05223319594577,64.94776680405423
MI,2014,618479,878128,852639,326800,187538,2863584,6.549065786091835,93.45093421390817
MN,2014,313073,490111,597383,132904,211351,1744822,12.113040757166061,87.88695924283394
MO,2014,780707,301368,615765,97021,86678,1881539,4.606760742137155,95.39323925786285
MS,2014,116537,439557,367974,107228,77940,1109236,7.0264578502681125,92.97354214973188
MT,2014,175357,80063,169826,0,55608,480854,11.564424960590948,88.43557503940904
NC,2014,501592,462289,835571,428474,177290,2405216,7.3710635552066845,92.62893644479331
ND,2014,399195,89095,236433,0,56211,780934,7.197919414444755,92.80208058555525
NE,2014,276544,179705,235052,105655,131709,928665,14.18261698244254,85.81738301755746
NH,2014,14867,58785,155103,106350,50560,385665,13.10982329223549,86.89017670776451
NJ,2014,30731,805145,857414,329533,80738,2103561,3.838158246896572,96.16184175310343
NM,2014,215348,256056,241004,0,29708,742116,4.00314775587644,95.99685224412356
NV,2014,79230,261902,277175,0,35607,653914,5.445211449823677,94.55478855017633
NY,2014,64655,1392378,1381651,450141,252145,3540970,7.120788936364894,92.87921106363511
OH,2014,1057377,1058802,1064130,170319,151836,3502464,4.335119504440303,95.6648804955597
OK,2014,336080,667360,534645,0,95986,1634071,5.874040968844071,94.12595903115593
OR,2014,34238,226472,324671,0,232841,818222,28.45694689216374,71.54305310783626
PA,2014,1039161,1304080,1211166,823277,191585,4569269,4.192902628407301,95.8070973715927
RI,2014,0,91374,86121,0,7941,185436,4.282339998705753,95.71766000129425
SC,2014,305656,236040,480214,548246,144405,1714561,8.42227252340395,91.57772747659605
SD,2014,33062,83919,114768,0,92163,323912,28.45309837239744,71.54690162760257
TN,2014,427509,313887,673649,289401,139689,1844135,7.574770827515339,92.42522917248466
TX,2014,1585961,4060590,5795452,410907,383577,12236487,3.134698708869629,96.86530129113036
UT,2014,344054,251649,276367,0,18400,890470,2.0663245252507103,97.9336754747493
VA,2014,278183,438697,831310,316081,163416,2027687,8.059232021510223,91.94076797848977
VT,2014,0,10853,79888,52929,26073,169743,15.360279952634276,84.63972004736573
WA,2014,76547,320167,683758,99332,427691,1607495,26.60605476222321,73.39394523777679
WI,2014,417096,479396,543928,98807,169963,1709190,9.944067072706956,90.05593292729304
WV,2014,816460,180222,192956,0,40889,1230527,3.3228852353503826,96.67711476464962
WY,2014,489300,142268,172327,0,23776,827671,2.8726390075283534,97.12736099247165
US,2014,17996577,27376838,34655737,8337559,6795497,95162208,7.140961882683512,92.85903811731649
AK,2015,19511,333936,236497,0,13526,603470,2.2413707392248163,97.75862926077518
AL,2015,494311,701582,512940,438728,225388,2372949,9.498223518499556,90.50177648150044
AR,2015,226889,296826,315144,144716,107425,1091000,9.84647112740605,90.15352887259395
AZ,2015,385822,365313,561290,340153,79520,1732098,4.590964252600026,95.40903574739997
CA,2015,30967,2384061,3168455,193529,564184,6341196,8.89712287713548,91.10287712286451
CO,2015,340107,490642,482097,0,76060,1388906,5.4762525325687985,94.5237474674312
CT,2015,6536,260925,314538,182083,43162,807244,5.346834414377809,94.65316558562219
DC,2015,44,33654,20468,0,1644,55810,2.9457086543630173,97.05429134563698
DE,2015,7149,107819,109134,0,6986,231088,3.0230907706155232,96.97690922938447
FL,2015,466530,1378089,1698137,294099,292986,4129841,7.094365134154075,92.90563486584593
GA,2015,394665,712580,999583,353883,284373,2745084,10.35935512355906,89.64064487644094
HI,2015,15632,196,253425,0,19137,288390,6.635805679808593,93.3641943201914
IA,2015,348293,302936,413902,54836,318378,1438345,22.135023238513707,77.86497676148629
ID,2015,4249,107871,177126,0,88708,377954,23.47058107600396,76.52941892399605
IL,2015,850430,1011357,1234916,1017377,201990,4316070,4.679951900687431,95.32004809931257
IN,2015,1007472,735055,752992,0,143592,2639111,5.440923098725291,94.55907690127471
KS,2015,273416,280421,341744,90254,84689,1070524,7.910985648149878,92.08901435185012
KY,2015,796484,276867,591467,0,69302,1734120,3.9963785666505203,96.00362143334948
LA,2015,174221,1594207,1716552,160015,150561,3795556,3.9667706127903264,96.03322938720967
MA,2015,24177,457124,579085,52236,74530,1187152,6.278050325484858,93.72194967451514
MD,2015,165994,225969,500187,153140,58890,1104180,5.333369559310982,94.66663044068902
ME,2015,2588,54203,195265,0,140477,392533,35.78730960199525,64.21269039800475
MI,2015,617280,871834,866251,306773,201650,2863788,7.04137317427128,92.95862682572871
MN,2015,271570,448557,589200,125900,215508,1650735,13.055275377331915,86.94472462266809
MO,2015,696401,270885,624483,109182,79087,1780038,4.442995037184599,95.5570049628154
MS,2015,71626,536996,378769,122511,73695,1183597,6.226359140822425,93.77364085917758
MT,2015,178421,77443,166418,0,59324,481606,12.317952849424634,87.68204715057537
NC,2015,405525,516026,858916,440248,171808,2392523,7.181038593986348,92.81896140601366
ND,2015,408091,100852,193911,0,58246,761100,7.6528708448298515,92.34712915517015
NE,2015,266319,170346,235128,107976,135625,915394,14.816024575210237,85.18397542478976
NH,2015,10989,70742,152917,99186,57118,390952,14.609977695471567,85.39002230452843
NJ,2015,22925,778866,879189,347851,70278,2099109,3.34799193372045,96.65200806627955
NM,2015,215703,260038,238421,0,31414,745576,4.213386696996684,95.78661330300332
NV,2015,36635,312602,268357,0,40761,658355,6.191340538159504,93.80865946184049
NY,2015,41241,1396693,1383416,466457,266962,3554769,7.509967595644049,92.49003240435596
OH,2015,865714,1031716,1083409,181726,146601,3309166,4.430149469685111,95.5698505303149
OK,2015,280748,711393,520830,0,104713,1617684,6.47301945250123,93.52698054749877
OR,2015,26515,245897,322385,0,225883,820680,27.523882633913342,72.47611736608665
PA,2015,878829,1313350,1192176,842044,196780,4423179,4.448836459026415,95.55116354097359
RI,2015,0,96514,85001,0,9241,190756,4.844408563819749,95.15559143618025
SC,2015,241217,284013,512457,555909,137393,1730989,7.937254367301005,92.06274563269899
SD,2015,19616,83370,116051,0,94546,313583,30.150231358205005,69.849768641795
TN,2015,370650,322468,689054,261037,139641,1782850,7.832459264660516,92.16754073533949
TX,2015,1340422,4263856,6017336,411571,394057,12427242,3.170912741539917,96.82908725846008
UT,2015,330043,242848,278792,0,22379,874062,2.5603446895071515,97.43965531049285
VA,2015,232427,526314,836415,293455,163521,2052132,7.968347065393454,92.03165293460654
VT,2015,0,12245,81995,0,32235,126475,25.48725044475193,74.51274955524808
WA,2015,58273,327738,735010,85347,415545,1621913,25.62067139236198,74.37932860763802
WI,2015,408189,476969,535218,104666,176655,1701697,10.381107800037256,89.61889219996274
WV,2015,730949,191059,189768,0,28924,1140700,2.5356360129744893,97.46436398702551
WY,2015,487177,126421,159867,0,24975,798440,3.127974550373228,96.87202544962678
US,2015,15548985,28179686,35366087,8336886,6822195,94253839,7.238108359702993,92.76189164029701
AK,2016,16613,330883,220481,0,14371,582348,2.467768413388558,97.53223158661145
AL,2016,410168,715033,540018,417334,217520,2300073,9.457091144498458,90.54290885550154
AR,2016,246437,315617,323431,140370,105871,1131726,9.354826168171448,90.64517383182856
AZ,2016,323878,373916,581762,338636,83630,1701822,4.914144957580757,95.08585504241924
CA,2016,32077,2248939,3283869,197754,645141,6407780,10.068089104182729,89.93191089581727
CO,2016,321476,464749,484385,0,86993,1357603,6.407837932002213,93.59216206799779
CT,2016,2340,254652,292707,173363,47246,770308,6.133390799524346,93.86660920047565
DC,2016,34,30160,19530,0,2020,51744,3.903834260977118,96.09616573902288
DE,2016,8199,113552,110362,0,6905,239018,2.888903764570032,97.11109623542997
FL,2016,426188,1414358,1741139,306658,289945,4178288,6.939325388771669,93.06067461122834
GA,2016,399279,727336,973508,360633,274692,2735448,10.041938285794503,89.9580617142055
HI,2016,16431,162,251439,0,21032,289064,7.275897379127113,92.72410262087288
IA,2016,298006,317115,423838,49185,330156,1418300,23.278290911654796,76.72170908834521
ID,2016,2432,110344,178164,0,84813,375753,22.571476475237723,77.42852352476228
IL,2016,702467,1045034,1241379,1031331,209408,4229619,4.950989675429394,95.0490103245706
IN,2016,948386,779945,728550,0,151702,2608583,5.815494465769347,94.18450553423065
KS,2016,253121,276404,342971,86245,96476,1055217,9.142764000200907,90.85723599979909
KY,2016,736584,279935,601343,0,71524,1689386,4.233727519939197,95.7662724800608
LA,2016,140513,1718305,1700147,179391,167421,3905777,4.2864966433055445,95.71350335669446
MA,2016,20115,440725,560064,56628,76017,1153549,6.589837102715186,93.41016289728482
MD,2016,162931,229508,474710,154377,59011,1080537,5.461266018655539,94.53873398134446
ME,2016,2194,54509,186306,0,121928,364937,33.41069828490945,66.58930171509056
MI,2016,471236,926828,881817,329999,197316,2807196,7.028935635416978,92.97106436458301
MN,2016,261250,466365,613012,144970,217542,1703139,12.773003260450263,87.22699673954973
MO,2016,639860,273583,620998,98630,79160,1712231,4.623207966682066,95.37679203331794
MS,2016,61219,561342,387624,61680,76228,1148093,6.6395318149313685,93.36046818506863
MT,2016,161938,77589,168868,0,61412,469807,13.07175074019757,86.92824925980243
NC,2016,381761,540271,880644,447500,177504,2427680,7.3116720490344695,92.68832795096553
ND,2016,394579,105625,164459,0,66368,731031,9.078684761658534,90.92131523834146
NE,2016,240465,172929,233507,97798,141113,885812,15.930355425304692,84.0696445746953
NH,2016,5277,59638,146868,112551,52757,377091,13.990522181648462,86.00947781835154
NJ,2016,17455,793928,890052,312569,73768,2087772,3.5333360156185636,96.46666398438144
NM,2016,197083,259158,237261,0,37378,730880,5.114109019264449,94.88589098073555
NV,2016,30765,316653,291755,0,46291,685464,6.753235764387335,93.24676423561266
NY,2016,29679,1336455,1382691,434791,269722,3453338,7.810472070790638,92.18952792920936
OH,2016,825311,994162,1084602,175893,147894,3227862,4.581794388979454,95.41820561102054
OK,2016,221842,736164,518889,0,128854,1605749,8.024541818179554,91.97545818182044
OR,2016,19440,249829,325735,0,237758,832762,28.55053424627925,71.44946575372074
PA,2016,734838,1354340,1142664,867302,194770,4293914,4.5359548421323765,95.46404515786763
RI,2016,0,88471,73271,0,8743,170485,5.128310408540341,94.87168959145966
SC,2016,221865,284225,523196,583883,138887,1752056,7.927086805444575,92.07291319455543
SD,2016,26660,85021,113576,0,99312,324569,30.598116271116464,69.40188372888353
TN,2016,379775,336341,703952,309357,130839,1860264,7.033356555843687,92.96664344415632
TX,2016,1323111,4151065,6167821,440109,464206,12546312,3.6999398707763684,96.30006012922364
UT,2016,269016,250199,288064,0,28527,835806,3.4131126122569113,96.58688738774309
VA,2016,222938,572103,846375,310966,160048,2112430,7.576487741605639,92.42351225839437
VT,2016,0,12383,77816,0,29703,119902,24.77273106370202,75.22726893629797
WA,2016,53302,324929,804683,100674,444891,1728479,25.738872152915945,74.26112784708405
WI,2016,357335,501042,525065,106173,174422,1664037,10.481858275987854,89.51814172401215
WV,2016,751957,188491,199293,0,30604,1170345,2.6149554191285476,97.38504458087145
WY,2016,457315,132478,154323,0,27129,771245,3.517559271048759,96.48244072895125
US,2016,14227138,28392790,35708988,8426753,7109458,93865127,7.574120684884387,92.42587931511561
AK,2017,16376,343899,217142,0,13136,590553,2.2243558156507546,97.77564418434925
AL,2017,378890,681208,531216,446097,229887,2267298,10.139249450226657,89.86075054977334
AR,2017,267591,317530,321820,132736,103841,1143518,9.080836506290238,90.91916349370976
AZ,2017,334512,334629,588253,338246,88295,1683935,5.243373408118484,94.75662659188151
CA,2017,33663,2190994,3364148,187227,724945,6500977,11.151323870242889,88.84867612975711
CO,2017,315835,462135,492391,0,88198,1358559,6.492025741981026,93.50797425801898
CT,2017,2507,246532,295938,172570,44621,762168,5.854483525941787,94.14551647405821
DC,2017,30,30607,16952,0,1959,49548,3.9537418261080166,96.04625817389199
DE,2017,4804,103121,112793,0,7068,227786,3.1029123826749667,96.89708761732503
FL,2017,407538,1421271,1760243,304840,300547,4194439,7.165368241140234,92.83463175885977
GA,2017,344273,709671,1029867,352560,268645,2705016,9.931364546457397,90.0686354535426
HI,2017,14948,163,261256,0,19116,295483,6.469407715503092,93.5305922844969
IA,2017,300287,376298,406090,54528,342722,1479925,23.15806544250553,76.84193455749447
ID,2017,2615,115899,178786,0,94432,391732,24.106276740220355,75.89372325977965
IL,2017,685000,1034583,1244089,1016522,210459,4190653,5.022105146858974,94.97789485314102
IN,2017,929271,747919,701895,0,151217,2530302,5.9762431520031996,94.0237568479968
KS,2017,216747,279097,335994,111367,111662,1054867,10.585410293430357,89.41458970656964
KY,2017,639356,296673,578656,0,77592,1592277,4.873021465486219,95.12697853451378
LA,2017,142267,1716392,1814751,161171,154436,3989017,3.871530254195457,96.12846974580454
MA,2017,12407,462406,562893,52788,73642,1164136,6.325893194609565,93.67410680539044
MD,2017,106973,232723,471681,158004,60690,1030071,5.891826874069846,94.10817312593015
ME,2017,2168,45125,181750,0,121133,350176,34.59203372018642,65.40796627981358
MI,2017,499439,908197,871111,338675,197415,2814837,7.013372355131043,92.98662764486896
MN,2017,257594,466884,606185,145426,217590,1693679,12.847180605061526,87.15281939493848
MO,2017,709796,264614,612257,86853,82699,1756219,4.708922976006979,95.29107702399303
MS,2017,53779,543721,385021,77027,70825,1130373,6.2656309023658565,93.73436909763414
MT,2017,156073,83319,174471,0,64575,478438,13.497046639271964,86.50295336072804
NC,2017,350286,520659,887207,443192,185491,2386835,7.771421149765275,92.22857885023473
ND,2017,397875,112146,184067,0,84388,778476,10.8401543528638,89.1598456471362
NE,2017,233809,175613,234034,72300,148734,864490,17.204825966754964,82.79517403324503
NH,2017,3617,53633,152753,104493,54900,369396,14.862099210603255,85.13790078939674
NJ,2017,16488,734147,860203,355948,69317,2036103,3.4043955536630515,96.59560444633695
NM,2017,199114,249357,251101,0,41939,741511,5.655883729304083,94.34411627069592
NV,2017,27297,305309,308778,0,50374,691758,7.282026373384912,92.71797362661509
NY,2017,19553,1276905,1379355,441029,283969,3400811,8.35003768218816,91.64996231781184
OH,2017,810953,1014299,1075597,184997,144526,3230372,4.4739738952665515,95.52602610473345
OK,2017,198309,692145,543829,0,142535,1576818,9.039407211231733,90.96059278876827
OR,2017,18723,262532,332167,0,255253,868675,29.384177051256223,70.61582294874377
PA,2017,669540,1404240,1156090,870187,197812,4297869,4.602560012880802,95.3974399871192
RI,2017,0,94730,73643,0,9570,177943,5.37812670349494,94.62187329650506
SC,2017,192751,287408,525000,568390,142086,1715635,8.281831508450225,91.71816849154978
SD,2017,26114,85339,112934,0,100635,325022,30.962519460221156,69.03748053977884
TN,2017,334567,331613,695633,332779,132019,1826611,7.227537773505142,92.77246222649485
TX,2017,1451978,3987778,6282478,403523,500540,12626297,3.9642660076822205,96.03573399231777
UT,2017,274816,231151,297201,0,34373,837541,4.104037891876338,95.89596210812367
VA,2017,159813,596648,849146,319562,159211,2084380,7.6382905228413245,92.36170947715867
VT,2017,0,12281,77459,0,30206,119946,25.182999016223967,74.81700098377603
WA,2017,61732,350872,773325,85013,449455,1720397,26.125074619404707,73.87492538059529
WI,2017,388614,504808,523815,100919,173139,1691295,10.237066862965952,89.76293313703405
WV,2017,710445,199298,191473,0,30601,1131817,2.7037056343914254,97.29629436560857
WY,2017,458496,158370,155620,0,27704,800190,3.462177732788463,96.53782226721154
US,2017,13839632,28056891,36040556,8418968,7373260,93729307,7.866547012878266,92.13345298712173
AK,2018,17325,346255,216500,0,13694,593774,2.3062646730911087,97.6937353269089
AL,2018,377152,771194,519594,412584,233969,2314493,10.108866175011114,89.89113382498888
AR,2018,304145,366939,327170,132996,105007,1236257,8.493945838122656,91.50605416187734
AZ,2018,331492,400531,594895,325122,92790,1744830,5.317996595656884,94.68200340434312
CA,2018,33256,2209801,3388089,190422,690792,6512360,10.607398853871715,89.39260114612829
CO,2018,284474,518088,514818,0,90564,1407944,6.432358105151909,93.5676418948481
CT,2018,4023,285991,312555,176496,46799,825864,5.666671510079142,94.33332848992086
DC,2018,37,32623,19051,0,2257,53968,4.182107915801956,95.81789208419805
DE,2018,4296,99416,119614,0,7209,230535,3.1270739800897913,96.87292601991021
FL,2018,327807,1511134,1846396,306461,301910,4293708,7.031451603136497,92.9685483968635
GA,2018,340152,759205,1000241,359262,272511,2731371,9.977077445722314,90.02292255427768
HI,2018,14367,192,260753,0,18927,294239,6.43252593979724,93.56747406020276
IA,2018,325673,431513,415055,51181,351235,1574657,22.305492561237145,77.69450743876286
ID,2018,2823,115833,182667,0,98338,399661,24.605353036698602,75.3946469633014
IL,2018,704574,1127424,1244958,1025651,204322,4306929,4.744029910871528,95.25597008912847
IN,2018,985668,890433,705476,0,155711,2737288,5.688513594477453,94.31148640552254
KS,2018,227665,321809,344549,95854,114768,1104645,10.389582173458441,89.61041782654156
KY,2018,655909,356673,601980,0,78493,1693055,4.636175434347969,95.36382456565204
LA,2018,137818,1865382,1730287,179330,150850,4063667,3.7121644071721427,96.28783559282786
MA,2018,101,452093,577406,46437,75874,1151911,6.586793597769272,93.41320640223073
MD,2018,124191,312824,478723,156699,64791,1137228,5.69727442518123,94.30272557481877
ME,2018,2113,48370,171310,0,122829,344622,35.64165955742814,64.35834044257186
MI,2018,506105,1010919,897773,318655,205713,2939165,6.999028635683945,93.00097136431606
MN,2018,261530,514172,613757,152657,223380,1765496,12.65253503831218,87.34746496168782
MO,2018,668188,330552,620788,111401,87913,1818842,4.833459970684644,95.16654002931536
MS,2018,60015,591886,381825,72343,70844,1176913,6.019476375908839,93.98052362409116
MT,2018,152295,90778,173316,0,69952,486341,14.383323635062641,85.61667636493736
NC,2018,325121,599308,907883,439915,195967,2468194,7.9396919366954135,92.06030806330459
ND,2018,407262,130084,190111,0,83349,810806,10.279770993307894,89.72022900669211
NE,2018,264072,196445,240019,58884,150750,910170,16.562839909027982,83.43716009097201
NH,2018,7798,51471,155784,105195,51626,371874,13.88265918025998,86.11734081974002
NJ,2018,16732,799555,890287,334373,69202,2110149,3.2794840553913494,96.72051594460865
NM,2018,136824,281322,259305,0,50352,727803,6.918355653933825,93.08164434606617
NV,2018,34996,310875,310292,0,54345,710508,7.648752723403537,92.35124727659647
NY,2018,16710,1393657,1420427,448718,289292,3568804,8.106133035044794,91.89386696495521
OH,2018,717818,1236747,1091837,191483,145712,3383597,4.3064230166890445,95.69357698331096
OK,2018,171280,842224,541014,0,156838,1711356,9.164545541664037,90.83545445833596
OR,2018,16911,271311,336118,0,252838,877178,28.82402431433529,71.17597568566471
PA,2018,644056,1515912,1174673,872749,203909,4411299,4.622425276545526,95.37757472345447
RI,2018,0,104748,80769,0,10167,195684,5.19562151223401,94.80437848776599
SC,2018,205204,338951,527000,551151,145716,1768022,8.241752647874291,91.75824735212571
SD,2018,27618,95548,115626,0,106322,345114,30.807791048754904,69.19220895124509
TN,2018,251835,404318,702085,378224,139464,1875926,7.434408393508059,92.56559160649194
TX,2018,1189311,4596600,6720119,430597,538210,13474837,3.9941856068463015,96.0058143931537
UT,2018,273117,253819,312517,0,34023,873476,3.8951270555802333,96.10487294441977
VA,2018,149349,667004,871407,305826,171314,2164900,7.913252344219132,92.08674765578087
VT,2018,0,14208,75874,0,33556,123638,27.14052314013491,72.85947685986508
WA,2018,61166,334779,778897,101502,448489,1724833,26.001879602257144,73.99812039774285
WI,2018,362077,565291,549724,105900,179416,1762408,10.180162595721308,89.81983740427869
WV,2018,661760,221402,217237,0,33833,1134232,2.9828994420894492,97.01710055791055
WY,2018,455748,175639,160729,0,26135,818251,3.1940077066816905,96.80599229331831
US,2018,13249958,31163246,36889282,8438068,7525401,97265955,7.736932208191448,92.26306779180855
AK,2019,17620,343384,221845,0,12952,595801,2.173880204967766,97.82611979503223
AL,2019,317180,748731,530699,455865,232118,2284593,10.160146686959122,89.83985331304088
AR,2019,239798,371388,331550,141750,106732,1191218,8.959904904056184,91.04009509594381
AZ,2019,257727,484249,611851,333312,92495,1779634,5.19741699697803,94.80258300302197
CA,2019,30886,2218732,3371632,168799,788792,6578841,11.989832251607844,88.01016774839215
CO,2019,273338,553842,527886,0,98087,1453153,6.749943054860706,93.25005694513929
CT,2019,867,293149,301091,174730,46250,816087,5.667287923959088,94.3327120760409
DC,2019,5,31603,18605,0,2515,52728,4.769761796389015,95.23023820361098
DE,2019,2179,93442,120540,0,7653,223814,3.419357144771998,96.580642855228
FL,2019,233542,1578269,1808570,303946,293232,4217559,6.952647254015889,93.04735274598411
GA,2019,273109,786904,998421,350759,281843,2691036,10.473401322018733,89.52659867798127
HI,2019,14179,228,263777,0,18371,296555,6.19480366205257,93.80519633794744
IA,2019,266368,433368,425711,54671,369139,1549257,23.826840866299136,76.17315913370086
ID,2019,2364,133257,184742,0,96734,417097,23.192207088518977,76.80779291148102
IL,2019,591909,1180447,1230428,1030996,208688,4242468,4.919023549499961,95.08097645050005
IN,2019,821545,934151,712531,0,149685,2617912,5.717724659958012,94.28227534004199
KS,2019,197779,319950,353607,96565,122904,1090805,11.267275085831107,88.7327249141689
KY,2019,574502,361174,596750,0,78258,1610684,4.858681156576957,95.14131884342304
LA,2019,90701,1963929,1738167,145993,139777,4078567,3.4271105513284446,96.57288944867156
MA,2019,71,442794,573476,22734,75036,1114111,6.735056022245539,93.26494397775446
MD,2019,77301,311631,475395,156765,57955,1079047,5.37094306364783,94.62905693635217
ME,2019,2160,46301,167089,0,120891,336441,35.932303137845864,64.06769686215414
MI,2019,447823,1054986,881682,343639,201965,2930095,6.892779926930697,93.1072200730693
MN,2019,205139,549487,624936,147280,224857,1751699,12.836509012107674,87.16349098789233
MO,2019,584662,327798,624035,95961,91830,1724286,5.325682630375703,94.67431736962429
MS,2019,51028,583800,384298,115202,66986,1201314,5.576060880003063,94.42393911999693
MT,2019,159165,92649,176840,0,65468,494122,13.249359469928478,86.75064053007152
NC,2019,318154,569405,907964,437683,198559,2431765,8.165221557181718,91.83477844281828
ND,2019,372018,157419,188562,0,84942,802941,10.578859467881202,89.4211405321188
NE,2019,240414,198771,243884,72589,156735,912393,17.17845270623514,82.82154729376485
NH,2019,4182,55366,152576,113890,50985,376999,13.523908551481568,86.47609144851843
NJ,2019,13780,790685,845192,278147,67919,1995723,3.4032278026559797,96.59677219734402
NM,2019,151468,305538,263741,0,56637,777384,7.2855885894229875,92.71441141057701
NV,2019,37177,315564,308582,0,58266,719589,8.097122107202862,91.90287789279714
NY,2019,13648,1337750,1384071,468481,291996,3495946,8.35241734283081,91.6475826571692
OH,2019,594257,1260474,1072889,177624,145507,3250751,4.476104137167073,95.52389586283293
OK,2019,93953,873688,524310,0,166473,1658424,10.038024051750336,89.96197594824966
OR,2019,27430,302229,329326,0,236857,895842,26.439595375077303,73.5604046249227
PA,2019,568781,1679486,1139848,869084,193105,4450304,4.339141775483203,95.6608582245168
RI,2019,0,97931,75638,0,11079,184648,6.000064988518695,93.9999350114813
SC,2019,160703,347904,517268,585828,145436,1757139,8.276863697180474,91.72313630281953
SD,2019,31420,97428,116587,0,110493,355928,31.043638039153986,68.95636196084601
TN,2019,216876,420285,715670,372992,134222,1860045,7.216061976995181,92.78393802300482
TX,2019,992721,4795212,6850873,431234,562206,13632246,4.12408931000805,95.87591068999195
UT,2019,266989,276460,307382,0,34539,885370,3.901080904028824,96.09891909597117
VA,2019,85120,717725,875131,308013,158027,2144016,7.37060730890068,92.62939269109933
VT,2019,0,14381,77481,0,32740,124602,26.27566170687469,73.72433829312531
WA,2019,80837,378216,797541,92584,396217,1745395,22.700706716817685,77.29929328318232
WI,2019,280108,592529,548818,104736,177141,1703332,10.39967545962854,89.60032454037146
WV,2019,621722,239854,208654,0,31899,1102129,2.8943072907073493,97.10569270929265
WY,2019,410221,172235,156476,0,27656,766588,3.607674526603599,96.3923254733964
US,2019,11314925,32236174,36864618,8451852,7585112,96452681,7.8640758570516045,92.1359241429484
AK,2020,18527,374561,223361,0,9757,626206,1.558113464259365,98.44188653574064
AL,2020,256687,714871,527241,454930,235538,2189267,10.758760808983098,89.2412391910169
AR,2020,161980,335436,316437,157349,91389,1062591,8.60058103258921,91.3994189674108
AZ,2020,156821,513540,549587,329597,90813,1640358,5.536169543477704,94.4638304565223
CA,2020,28034,2153254,2658831,169838,738585,5748542,12.848214382011996,87.15178561798801
CO,2020,217082,552070,439968,0,95342,1304462,7.308913559766402,92.6910864402336
CT,2020,67,298125,259321,164157,46525,768195,6.056404949264184,93.94359505073582
DC,2020,0,27984,15533,0,2345,45862,5.113165583707644,94.88683441629236
DE,2020,1956,89293,104806,0,6793,202848,3.3488129042435717,96.65118709575643
FL,2020,180387,1619429,1488608,307315,278475,3874214,7.187909599211608,92.81209040078839
GA,2020,153179,779340,878175,342897,286918,2440509,11.756481947003678,88.24351805299632
HI,2020,13281,199,187496,0,18381,219357,8.37949096678018,91.62050903321982
IA,2020,183017,396343,399538,30344,366009,1375251,26.613978102906305,73.3860218970937
ID,2020,2663,129363,177456,0,79773,389255,20.493763728147357,79.50623627185264
IL,2020,391150,1158248,1048897,1047170,207643,3853108,5.388974303341614,94.61102569665839
IN,2020,669310,873263,654491,0,139422,2336486,5.967166077605429,94.03283392239457
KS,2020,193779,301035,335653,110545,129820,1070832,12.123283577629357,87.87671642237065
KY,2020,482266,344941,541682,0,69134,1438023,4.807572618796779,95.19242738120322
LA,2020,48718,1921961,1777892,177055,135467,4061093,3.335727598456869,96.66427240154313
MA,2020,0,400675,450385,0,71436,922496,7.743773414735673,92.25622658526433
MD,2020,49692,294026,398947,157531,48564,948760,5.118681226021333,94.88131877397866
ME,2020,1657,47028,157778,0,98142,304605,32.219431723051166,67.78056827694884
MI,2020,334428,1004204,755679,316854,183360,2594525,7.067189562636706,92.93281043736329
MN,2020,162702,496026,532917,153319,206259,1551223,13.29654085840656,86.70345914159344
MO,2020,551341,303719,577971,80874,77057,1590962,4.843421778772843,95.15657822122715
MS,2020,54188,610285,370803,67595,65069,1167940,5.571262222374437,94.42873777762556
MT,2020,98886,87481,176567,0,59812,422746,14.148448477336272,85.85155152266373
NC,2020,223906,557570,810095,442166,202724,2236461,9.06449967157934,90.93550032842066
ND,2020,363255,182601,163773,0,89718,799347,11.223911517776385,88.77608848222361
NE,2020,213747,192725,229238,64646,145474,845830,17.198964330893915,82.80103566910608
NH,2020,1518,53630,137120,103052,37794,333114,11.345665447864695,88.65433455213531
NJ,2020,12144,678931,688552,279308,66791,1725726,3.8703131319803954,96.1296868680196
NM,2020,138968,292626,238713,0,49823,720130,6.918611917292711,93.08138808270729
NV,2020,27778,310715,247573,0,57527,643593,8.938412941097868,91.06158705890213
NY,2020,5681,1305282,1065217,401441,260799,3038420,8.583375570197669,91.41662442980233
OH,2020,556769,1235037,984765,190316,139734,3106621,4.497941654292558,95.50205834570744
OK,2020,70714,844903,474829,0,166862,1557308,10.714771901255244,89.28522809874475
OR,2020,17811,282518,294458,0,235164,829951,28.33468481874231,71.66531518125768
PA,2020,374254,1783781,954960,799342,177574,4089911,4.341757070019372,95.65824292998063
RI,2020,0,100985,67006,0,11883,179874,6.606291070415958,93.39370892958404
SC,2020,137280,343349,467302,571930,143995,1663856,8.654294602417517,91.34570539758248
SD,2020,21692,91230,120095,0,109622,342639,31.993439158998246,68.00656084100176
TN,2020,176104,398626,659522,383245,136076,1753573,7.759927872977059,92.24007212702294
TX,2020,872845,4783306,6183653,432869,590850,12863523,4.593220690785875,95.40677930921413
UT,2020,244280,266597,287404,0,34213,832494,4.109699289124006,95.89030071087599
VA,2020,75434,748376,741816,314843,163057,2043526,7.979198698719761,92.02080130128024
VT,2020,0,13589,70486,0,20607,104682,19.68533272195793,80.31466727804207
WA,2020,59443,356925,624607,98475,406249,1545699,26.282542720154442,73.71745727984556
WI,2020,249316,571817,494470,102071,146560,1564234,9.369442167859797,90.6305578321402
WV,2020,539707,264267,179361,0,26009,1009344,2.57682217360979,97.42317782639022
WY,2020,388253,168444,139757,0,28935,725389,3.9888942346795995,96.0111057653204
US,2020,9182696,31654531,32330790,8251075,7290069,88709161,8.217943804022676,91.78205619597732
AK,2021,18694,395590,261094,0,9597,684975,1.4010730318624767,98.59892696813752
AL,2021,309791,739891,583042,480115,239817,2352656,10.19345794710319,89.80654205289682
AR,2021,216123,360545,328271,141372,89714,1136025,7.897185361237649,92.10281463876235
AZ,2021,160299,484962,606862,329868,99266,1681257,5.904272814923596,94.0957271850764
CA,2021,28244,2172757,2959389,171842,810020,6142252,13.18767123198462,86.81232876801538
CO,2021,252442,509970,497788,0,103955,1364155,7.620468348538106,92.37953165146189
CT,2021,2880,305184,284788,179551,49306,821709,6.000421073640425,93.99957892635958
DC,2021,0,28336,18439,0,2487,49262,5.048516097600585,94.95148390239942
DE,2021,4542,82708,113641,0,7150,208041,3.43682254940132,96.56317745059869
FL,2021,200193,1591864,1748346,307811,297291,4145505,7.17140613749109,92.82859386250891
GA,2021,203870,773889,922503,354085,289113,2543460,11.366917506074403,88.6330824939256
HI,2021,12566,133,223014,0,20134,255847,7.869547033969521,92.13045296603048
IA,2021,264419,383424,408385,0,389787,1446015,26.95594444041037,73.04405555958964
ID,2021,3051,135176,188263,0,74428,400918,18.56439471413107,81.43560528586893
IL,2021,522809,1088485,1136797,1011555,224106,3983752,5.625500784185361,94.37449921581464
IN,2021,753557,869328,712427,0,157324,2492636,6.311551305525556,93.68844869447445
KS,2021,219031,291797,339006,89426,135551,1074811,12.611612646316422,87.38838735368358
KY,2021,548443,365875,584011,0,71744,1570073,4.569469062903445,95.43053093709655
LA,2021,95856,1862349,1840835,179886,135905,4114831,3.3028087909321187,96.69719120906788
MA,2021,0,404301,503312,0,75370,982983,7.667477464004973,92.33252253599503
MD,2021,69186,299282,433791,156369,52732,1011360,5.213969308653694,94.78603069134631
ME,2021,1588,57233,163991,0,95141,317953,29.922976037338852,70.07702396266114
MI,2021,436203,950364,814081,358114,194075,2752837,7.049999691227632,92.95000030877237
MN,2021,179055,523812,561731,147286,216113,1627997,13.274778761877325,86.72522123812267
MO,2021,616413,293633,607276,44766,88879,1650967,5.38345103203153,94.61654896796847
MS,2021,64446,576903,384328,122771,66134,1214582,5.445000831561805,94.5549991684382
MT,2021,122765,87105,176686,0,56334,442890,12.719636930163245,87.28036306983675
NC,2021,222501,637553,884299,449675,196973,2391001,8.238097767420424,91.76190223257957
ND,2021,361811,191168,168682,0,92653,814314,11.378043359195592,88.62195664080441
NE,2021,216298,191008,237214,71758,158275,874553,18.09781682756791,81.90218317243209
NH,2021,3259,60116,142030,102789,38479,346673,11.099508758974595,88.9004912410254
NJ,2021,12586,697019,749892,293494,70039,1823030,3.8419005721244304,96.15809942787557
NM,2021,133228,285809,262885,0,62210,744132,8.360075900512275,91.63992409948773
NV,2021,35910,305212,286548,0,63647,691317,9.20663024343391,90.7933697565661
NY,2021,5370,1359437,1237451,325141,263977,3191376,8.271573139611252,91.72842686038875
OH,2021,575920,1294814,1028000,182330,146858,3227922,4.549614271968158,95.45038572803185
OK,2021,131695,745911,517408,0,177087,1572101,11.264352608388393,88.73564739161161
OR,2021,1303,305665,317322,0,225544,849834,26.539771296512026,73.46022870348797
PA,2021,485193,1868137,1047658,791587,179589,4372164,4.107554062473412,95.89244593752659
RI,2021,0,105473,76464,0,11798,193735,6.089761788009394,93.9102382119906
SC,2021,162628,349990,508147,560782,143796,1725343,8.334342794447249,91.66565720555275
SD,2021,21589,96787,119505,0,127382,365263,34.87404965737017,65.12595034262984
TN,2021,225784,413554,713210,368461,135841,1856850,7.3156690093437815,92.68433099065622
TX,2021,968401,4773076,6783182,419363,654199,13598221,4.810916074977749,95.18908392502225
UT,2021,276159,274420,304823,0,36050,891452,4.04396422914526,95.95603577085474
VA,2021,68603,699927,795296,297972,174615,2036413,8.574635891638877,91.42536410836112
VT,2021,0,13801,72241,0,21430,107472,19.940077415512878,80.05992258448713
WA,2021,36943,384769,711662,88764,394052,1616190,24.38153929921606,75.61846070078394
WI,2021,286760,561076,533390,103979,145936,1631141,8.946866028136133,91.05313397186387
WV,2021,633582,277002,205005,0,26427,1142016,2.3140656523201075,97.68593434767989
WY,2021,376971,161580,146274,0,37734,722559,5.2222725064666,94.7777274935334
US,2021,10548957,31688203,35250685,8130913,7646167,93264925,8.19833072293791,91.80166927706209
AK,2022,18615,437916,263335,0,10410,730276,1.4254884454644545,98.57451155453555
AL,2022,297654,787300,578431,442093,232035,2337513,9.926575809417958,90.07342419058205
AR,2022,211724,398099,327813,149654,90825,1178115,7.709349257075922,92.29065074292407
AZ,2022,154007,468038,594859,333738,101215,1651857,6.127346374413766,93.87265362558624
CA,2022,30049,2131372,3017944,183814,880995,6244174,14.109071912473931,85.89092808752606
CO,2022,233256,524890,538413,0,114917,1411476,8.141619127778297,91.8583808722217
CT,2022,0,307212,302881,172018,49084,831195,5.905232827435198,94.0947671725648
DC,2022,0,30174,18000,0,2622,50796,5.161823765650839,94.83817623434916
DE,2022,1846,89674,112026,0,7402,210948,3.5089216299751596,96.49107837002484
FL,2022,171953,1659544,1815529,321468,304605,4273099,7.128433017816811,92.87156698218318
GA,2022,180888,809618,940579,356001,293237,2580323,11.364352447348645,88.63564755265135
HI,2022,7680,159,241994,0,20471,270304,7.573324849058838,92.42667515094116
IA,2022,227866,434374,423592,0,421784,1507616,27.97688536072846,72.02311463927154
ID,2022,1881,141924,190635,0,78406,412846,18.99158524001686,81.00841475998314
IL,2022,496983,1134781,1138141,1032989,248541,4051435,6.134641182692058,93.86535881730794
IN,2022,719238,913401,699235,0,170986,2502860,6.831624621433081,93.16837537856692
KS,2022,226712,318779,346852,93844,151788,1137975,13.338430106109536,86.66156989389046
KY,2022,523276,402534,580349,0,77517,1583676,4.894751199108908,95.10524880089109
LA,2022,96914,2087166,1663129,168889,138209,4154307,3.3268846043395444,96.67311539566046
MA,2022,0,432442,529154,0,80700,1042296,7.74252227774068,92.25747772225932
MD,2022,61932,310133,411842,154742,51255,989904,5.177774814527469,94.82222518547253
ME,2022,1269,62559,166724,0,93867,324419,28.93387871857074,71.06612128142926
MI,2022,423504,1087716,820709,271788,206811,2810528,7.358439410673013,92.64156058932699
MN,2022,184517,535010,568916,153546,229769,1671758,13.744154357269414,86.25584564273059
MO,2022,566940,322547,606374,92724,95312,1683897,5.660203682291732,94.33979631770826
MS,2022,66214,617855,383366,89856,66614,1223905,5.442742696532819,94.55725730346718
MT,2022,131345,93971,177009,0,60644,462969,13.098933189911204,86.90106681008879
NC,2022,163029,747187,906477,445547,198165,2460405,8.05416181482317,91.94583818517683
ND,2022,369340,198986,170390,0,96024,834740,11.503462155880873,88.49653784411913
NE,2022,223571,199260,237556,58702,168382,887471,18.973239688958852,81.02676031104114
NH,2022,3864,60176,149025,114108,39863,367036,10.86078749768415,89.13921250231584
NJ,2022,6199,755048,769751,295875,73187,1900060,3.851825731818995,96.14817426818101
NM,2022,138077,301279,255571,0,77286,772213,10.008378517326179,89.99162148267382
NV,2022,35835,302315,303234,0,72734,714118,10.185151473565993,89.814848526434
NY,2022,6143,1403401,1321362,280133,269884,3280923,8.225855955778298,91.7741440442217
OH,2022,539587,1422175,1031807,175806,155282,3324657,4.670617149378116,95.32938285062188
OK,2022,106855,772405,521629,0,189654,1590543,11.923852420211212,88.0761475797888
OR,2022,1066,297591,315400,0,237768,851825,27.91277551140199,72.08722448859801
PA,2022,435540,1936985,1108074,795783,182051,4458433,4.083295633241545,95.91670436675845
RI,2022,0,93829,78260,0,13264,185353,7.156075164685761,92.84392483531424
SC,2022,150973,361249,495616,568055,145328,1721221,8.443308558285079,91.55669144171492
SD,2022,24769,98288,118593,0,129978,371628,34.97529787852368,65.02470212147631
TN,2022,204725,440017,707095,372319,116472,1840628,6.327840280599882,93.67215971940011
TX,2022,932569,5007366,6582173,434709,751680,13708497,5.48331447276824,94.51668552723176
UT,2022,237870,287076,322387,0,37369,884702,4.223908163426781,95.77609183657322
VA,2022,67739,665869,798162,294606,185638,2012014,9.22647655533212,90.77352344466787
VT,2022,0,14046,71534,0,22009,107589,20.45655224976531,79.54344775023469
WA,2022,42238,381886,725931,102929,418470,1671454,25.036285772746364,74.96371422725363
WI,2022,232501,622144,535483,105285,150890,1646303,9.165384500909006,90.83461549909099
WV,2022,536642,281657,201769,0,28391,1048459,2.7078788965519873,97.29212110344801
WY,2022,390303,172450,145723,0,42079,750555,5.606384608722879,94.39361539127712
US,2022,9885694,33361871,35330835,8061020,8107353,94746773,8.55686451716936,91.44313548283064
AK,2023,18414,448087,270391,0,10087,746979,1.3503726343043112,98.6496273656957
AL,2023,224926,775747,565754,476392,222189,2265008,9.809634226457478,90.19036577354252
AR,2023,180262,399566,327465,156492,87277,1151062,7.582302256524844,92.41769774347516
AZ,2023,137885,537151,599712,329474,108445,1712667,6.3319372650959,93.6680627349041
CA,2023,28746,2154533,2996168,185192,1065179,6429818,16.566238733351394,83.4337612666486
CO,2023,204826,525446,514174,0,115061,1359507,8.463435642479222,91.53656435752077
CT,2023,0,304924,292864,142873,48981,789642,6.202937533717812,93.79706246628218
DC,2023,0,26236,17292,0,2795,46323,6.033719750447942,93.96628024955206
DE,2023,338,84387,110721,0,8041,203487,3.9516037879569703,96.04839621204303
FL,2023,129387,1673836,1835394,312935,286306,4237858,6.755913010771008,93.24408698922899
GA,2023,177521,787361,980546,390663,291462,2627553,11.09252601184448,88.90747398815552
HI,2023,0,152,251676,0,21046,272874,7.712717224799724,92.28728277520028
IA,2023,201276,446677,404172,0,414801,1466926,28.276886495978665,71.72311350402133
ID,2023,1144,154150,189553,0,77128,421975,18.277860062799927,81.72213993720007
IL,2023,342683,1101064,1134461,1019691,245703,3843602,6.392519308710943,93.60748069128906
IN,2023,613533,921814,695709,0,172891,2403947,7.191963882731192,92.80803611726881
KS,2023,184614,309427,345807,107675,140268,1087791,12.894756437587736,87.10524356241227
KY,2023,481815,369986,584722,0,72603,1509126,4.810930300054468,95.18906969994553
LA,2023,58224,2055504,1620038,127634,138982,4000382,3.474218212160739,96.52578178783926
MA,2023,0,386946,525647,0,81559,994152,8.203876268417707,91.7961237315823
MD,2023,30349,304669,429784,156610,53711,975123,5.508125641585728,94.49187435841428
ME,2023,1295,61045,177091,0,89444,328875,27.19695933105283,72.80304066894716
MI,2023,287490,1104234,810789,292615,198459,2693587,7.3678333018387745,92.63216669816123
MN,2023,148968,536789,567072,124626,223864,1601319,13.979975257896772,86.02002474210323
MO,2023,442901,316512,612625,95947,90412,1558397,5.8016025441527415,94.19839745584726
MS,2023,49606,630107,378072,122807,67305,1247897,5.393473980625004,94.606526019375
MT,2023,130059,96777,173283,0,58470,458589,12.749978739132425,87.25002126086757
NC,2023,153784,662302,900241,442493,186804,2345624,7.963936248946975,92.03606375105302
ND,2023,325716,220768,169307,0,92154,807945,11.405974416575386,88.59402558342461
NE,2023,195602,206276,233599,72391,164502,872370,18.85690704632209,81.14309295367791
NH,2023,1838,59589,147387,99658,38988,347460,11.220859955102746,88.77914004489726
NJ,2023,0,721282,787262,296162,74408,1879114,3.9597384724928877,96.04026152750711
NM,2023,75182,337083,251686,0,80278,744229,10.786733653216954,89.21326634678304
NV,2023,29284,301655,296155,0,74878,701972,10.666807223080124,89.33319277691987
NY,2023,4823,1346622,1341811,287690,272967,3253913,8.388884398568738,91.61111560143127
OH,2023,413577,1448857,1009729,169392,153083,3194638,4.791873132417507,95.2081268675825
OK,2023,63787,860217,515440,0,185378,1624822,11.409126661258895,88.5908733387411
OR,2023,652,327164,313013,0,236062,876891,26.920335594731842,73.07966440526816
PA,2023,307604,1937041,1132958,787083,178035,4342721,4.099618649229366,95.90038135077063
RI,2023,0,112499,76844,0,13579,202922,6.691733769625768,93.30826623037423
SC,2023,162323,346881,507146,581365,142486,1740201,8.187904730545494,91.8120952694545
SD,2023,22246,99752,114623,0,126540,363161,34.84404988421114,65.15595011578887
TN,2023,202367,396870,702827,396522,115678,1814264,6.376029067434508,93.6239709325655
TX,2023,805600,5284670,6752349,425186,791211,14059016,5.6277836229790195,94.37221637702098
UT,2023,174315,298976,324640,0,39674,837605,4.736600187439187,95.26339981256082
VA,2023,46785,655997,807547,310037,183979,2004345,9.179008603808226,90.82099139619177
VT,2023,0,13001,70235,0,22209,105445,21.062165109772867,78.93783489022714
WA,2023,49523,403038,718277,88163,365956,1624957,22.52096517015527,77.47903482984472
WI,2023,219995,565025,525386,101204,150965,1562575,9.661296257779627,90.33870374222037
WV,2023,472309,309019,206969,0,28370,1016667,2.7904908883636432,97.20950911163635
WY,2023,366098,181395,143944,0,38474,729911,5.271053594205321,94.72894640579467
US,2023,8169673,33609104,35460356,8098974,8187317,93525424,8.754108401582869,91.24589159841713
